,GRID_ID,wave_group,wave_lifespan,wave_amplitude,wave_start_year,wave_decade,wave_end_year,max_amp,min_amp
0,AA-10,1,1,3,1928,1920,1929,6,3
1,AA-10,2,1,5,1975,1970,1976,6,3
2,AA-10,3,2,5,1980,1980,1982,6,3
3,AA-10,4,2,4,1984,1980,1986,6,3
4,AA-10,5,5,6,1989,1980,1994,6,3
5,AA-10,6,1,3,1995,1990,1996,6,3
6,AA-10,7,1,3,1997,1990,1998,6,3
7,AA-10,8,2,3,2001,2000,2003,6,3
8,AA-11,9,1,3,1967,1960,1968,9,3
9,AA-11,10,1,5,1974,1970,1975,9,3
10,AA-11,11,16,9,1976,1970,1992,9,3
11,AA-11,12,1,8,1993,1990,1994,9,3
12,AA-11,13,1,3,1995,1990,1996,9,3
13,AA-11,14,3,6,1998,1990,2001,9,3
14,AA-11,15,1,4,2003,2000,2004,9,3
15,AA-11,16,1,3,2005,2000,2006,9,3
16,AA-12,17,1,3,1970,1970,1971,7,3
17,AA-12,18,2,4,1973,1970,1975,7,3
18,AA-12,19,1,4,1979,1970,1980,7,3
19,AA-12,20,1,7,1981,1980,1982,7,3
20,AA-12,21,1,4,1991,1990,1992,7,3
21,AA-12,22,1,3,1997,1990,1998,7,3
22,AA-12,23,1,3,2009,2000,2010,7,3
23,AA-13,24,1,4,1971,1970,1972,6,3
24,AA-13,25,2,3,1977,1970,1979,6,3
25,AA-13,26,1,4,1980,1980,1981,6,3
26,AA-13,27,1,3,1984,1980,1985,6,3
27,AA-13,28,4,6,1987,1980,1991,6,3
28,AA-13,29,2,4,1993,1990,1995,6,3
29,AA-13,30,2,6,1996,1990,1998,6,3
30,AA-13,31,4,4,1999,1990,2003,6,3
31,AA-13,32,1,3,2014,2010,2015,6,3
32,AA-14,33,2,5,1929,1920,1931,14,4
33,AA-14,34,8,9,1955,1950,1963,14,4
34,AA-14,35,9,13,1964,1960,1973,14,4
35,AA-14,36,5,14,1974,1970,1979,14,4
36,AA-14,37,10,9,1980,1980,1990,14,4
37,AA-14,38,8,12,1992,1990,2000,14,4
38,AA-14,39,1,4,2003,2000,2004,14,4
39,AA-14,40,1,4,2007,2000,2008,14,4
40,AA-14,41,1,5,2010,2010,2011,14,4
41,AA-14,42,2,6,2015,2010,2017,14,4
42,AA-15,43,1,3,1922,1920,1923,11,3
43,AA-15,44,2,3,1928,1920,1930,11,3
44,AA-15,45,1,3,1941,1940,1942,11,3
45,AA-15,46,1,3,1943,1940,1944,11,3
46,AA-15,47,1,4,1953,1950,1954,11,3
47,AA-15,48,1,3,1957,1950,1958,11,3
48,AA-15,49,2,5,1961,1960,1963,11,3
49,AA-15,50,10,11,1964,1960,1974,11,3
50,AA-15,51,1,4,1975,1970,1976,11,3
51,AA-15,52,3,4,1979,1970,1982,11,3
52,AA-15,53,1,3,1983,1980,1984,11,3
53,AA-15,54,1,3,1986,1980,1987,11,3
54,AA-15,55,2,4,1988,1980,1990,11,3
55,AA-15,56,2,7,1992,1990,1994,11,3
56,AA-15,57,3,5,1995,1990,1998,11,3
57,AA-15,58,2,7,1999,1990,2001,11,3
58,AA-15,59,1,3,2002,2000,2003,11,3
59,AA-15,60,1,3,2009,2000,2010,11,3
60,AA-15,61,1,5,2013,2010,2014,11,3
61,AA-15,62,2,6,2015,2010,2017,11,3
62,AA-16,63,1,3,1923,1920,1924,17,3
63,AA-16,64,1,4,1950,1950,1951,17,3
64,AA-16,65,34,17,1952,1950,1986,17,3
65,AA-16,66,2,10,1987,1980,1989,17,3
66,AA-16,67,8,10,1990,1990,1998,17,3
67,AA-16,68,2,7,1999,1990,2001,17,3
68,AA-16,69,3,6,2002,2000,2005,17,3
69,AA-16,70,1,5,2006,2000,2007,17,3
70,AA-16,71,3,4,2011,2010,2014,17,3
71,AA-16,72,1,7,2016,2010,2017,17,3
72,AA-17,73,1,5,1957,1950,1958,11,3
73,AA-17,74,2,4,1961,1960,1963,11,3
74,AA-17,75,1,7,1964,1960,1965,11,3
75,AA-17,76,1,6,1966,1960,1967,11,3
76,AA-17,77,20,9,1968,1960,1988,11,3
77,AA-17,78,4,6,1989,1980,1993,11,3
78,AA-17,79,2,11,1994,1990,1996,11,3
79,AA-17,80,1,3,1997,1990,1998,11,3
80,AA-17,81,1,5,2000,2000,2001,11,3
81,AA-17,82,1,4,2003,2000,2004,11,3
82,AA-17,83,1,3,2005,2000,2006,11,3
83,AA-17,84,1,3,2012,2010,2013,11,3
84,AA-17,85,1,3,2016,2010,2017,11,3
85,AA-18,86,1,3,1972,1970,1973,7,3
86,AA-18,87,1,6,1974,1970,1975,7,3
87,AA-18,88,1,6,1976,1970,1977,7,3
88,AA-18,89,3,7,1978,1970,1981,7,3
89,AA-18,90,1,4,1982,1980,1983,7,3
90,AA-18,91,1,3,1986,1980,1987,7,3
91,AA-18,92,3,4,1990,1990,1993,7,3
92,AA-18,93,1,3,2004,2000,2005,7,3
93,AA-18,94,1,3,2007,2000,2008,7,3
94,AA-18,95,1,3,2011,2010,2012,7,3
95,AA-20,96,1,3,1978,1970,1979,4,3
96,AA-20,97,1,3,1993,1990,1994,4,3
97,AA-20,98,1,3,1995,1990,1996,4,3
98,AA-20,99,1,4,2000,2000,2001,4,3
99,AA-20,100,2,4,2002,2000,2004,4,3
100,AA-21,101,1,3,1973,1970,1974,3,3
101,AA-21,102,1,3,2016,2010,2017,3,3
102,AA-22,103,1,3,1992,1990,1993,5,3
103,AA-22,104,1,3,1999,1990,2000,5,3
104,AA-22,105,1,5,2001,2000,2002,5,3
105,AA-22,106,1,3,2010,2010,2011,5,3
106,AA-23,107,1,3,1965,1960,1966,3,3
107,AA-23,108,1,3,2005,2000,2006,3,3
108,AA-23,109,1,3,2010,2010,2011,3,3
109,AA-24,110,1,3,2002,2000,2003,5,3
110,AA-24,111,1,3,2004,2000,2005,5,3
111,AA-24,112,1,3,2008,2000,2009,5,3
112,AA-24,113,2,5,2015,2010,2017,5,3
113,AA-6,114,1,3,1980,1980,1981,4,3
114,AA-6,115,3,4,1983,1980,1986,4,3
115,AA-6,116,1,3,1988,1980,1989,4,3
116,AA-6,117,3,3,1994,1990,1997,4,3
117,AA-6,118,1,3,2002,2000,2003,4,3
118,AA-6,119,1,3,2004,2000,2005,4,3
119,AA-7,120,1,3,1973,1970,1974,4,3
120,AA-7,121,1,4,1990,1990,1991,4,3
121,AA-7,122,1,3,2003,2000,2004,4,3
122,AA-7,123,1,3,2008,2000,2009,4,3
123,AA-7,124,1,3,2016,2010,2017,4,3
124,AA-9,125,1,3,1982,1980,1983,4,3
125,AA-9,126,1,4,1992,1990,1993,4,3
126,AA-9,127,1,4,1994,1990,1995,4,3
127,AA-9,128,1,3,1997,1990,1998,4,3
128,AA-9,129,1,4,2006,2000,2007,4,3
129,AB-10,130,1,3,1954,1950,1955,3,3
130,AB-11,131,3,7,1973,1970,1976,10,3
131,AB-11,132,1,3,1977,1970,1978,10,3
132,AB-11,133,7,10,1979,1970,1986,10,3
133,AB-11,134,1,3,1987,1980,1988,10,3
134,AB-11,135,2,5,1989,1980,1991,10,3
135,AB-11,136,1,3,1992,1990,1993,10,3
136,AB-11,137,2,4,1994,1990,1996,10,3
137,AB-11,138,2,3,2002,2000,2004,10,3
138,AB-11,139,1,4,2009,2000,2010,10,3
139,AB-12,140,1,5,1955,1950,1956,9,3
140,AB-12,141,1,3,1968,1960,1969,9,3
141,AB-12,142,3,6,1971,1970,1974,9,3
142,AB-12,143,7,9,1976,1970,1983,9,3
143,AB-12,144,4,8,1985,1980,1989,9,3
144,AB-12,145,1,3,1990,1990,1991,9,3
145,AB-12,146,1,4,1992,1990,1993,9,3
146,AB-12,147,2,3,1994,1990,1996,9,3
147,AB-12,148,2,4,1998,1990,2000,9,3
148,AB-12,149,1,3,2001,2000,2002,9,3
149,AB-12,150,1,4,2004,2000,2005,9,3
150,AB-12,151,1,4,2009,2000,2010,9,3
151,AB-13,152,1,3,1962,1960,1963,12,3
152,AB-13,153,1,4,1968,1960,1969,12,3
153,AB-13,154,11,12,1971,1970,1982,12,3
154,AB-13,155,1,4,1983,1980,1984,12,3
155,AB-13,156,5,4,1986,1980,1991,12,3
156,AB-13,157,3,5,1993,1990,1996,12,3
157,AB-13,158,1,6,1998,1990,1999,12,3
158,AB-13,159,1,5,2003,2000,2004,12,3
159,AB-14,160,1,3,1946,1940,1947,5,3
160,AB-14,161,2,4,1948,1940,1950,5,3
161,AB-14,162,1,5,1952,1950,1953,5,3
162,AB-14,163,1,3,1958,1950,1959,5,3
163,AB-14,164,1,3,1973,1970,1974,5,3
164,AB-15,165,1,5,1928,1920,1929,13,3
165,AB-15,166,1,3,1930,1930,1931,13,3
166,AB-15,167,2,4,1948,1940,1950,13,3
167,AB-15,168,4,9,1951,1950,1955,13,3
168,AB-15,169,2,7,1956,1950,1958,13,3
169,AB-15,170,4,7,1959,1950,1963,13,3
170,AB-15,171,18,13,1964,1960,1982,13,3
171,AB-15,172,2,10,1983,1980,1985,13,3
172,AB-15,173,4,10,1986,1980,1990,13,3
173,AB-15,174,5,13,1991,1990,1996,13,3
174,AB-15,175,6,9,1997,1990,2003,13,3
175,AB-15,176,1,3,2006,2000,2007,13,3
176,AB-15,177,1,3,2009,2000,2010,13,3
177,AB-15,178,1,3,2016,2010,2017,13,3
178,AB-16,179,1,3,1925,1920,1926,7,3
179,AB-16,180,3,4,1960,1960,1963,7,3
180,AB-16,181,3,4,1965,1960,1968,7,3
181,AB-16,182,10,7,1969,1960,1979,7,3
182,AB-16,183,2,7,1980,1980,1982,7,3
183,AB-16,184,1,6,1984,1980,1985,7,3
184,AB-16,185,1,6,1987,1980,1988,7,3
185,AB-16,186,1,5,1989,1980,1990,7,3
186,AB-16,187,3,6,1991,1990,1994,7,3
187,AB-16,188,1,4,1996,1990,1997,7,3
188,AB-16,189,1,3,1999,1990,2000,7,3
189,AB-16,190,1,3,2003,2000,2004,7,3
190,AB-16,191,2,3,2011,2010,2013,7,3
191,AB-16,192,3,3,2014,2010,2017,7,3
192,AB-17,193,1,4,1971,1970,1972,6,3
193,AB-17,194,1,3,1974,1970,1975,6,3
194,AB-17,195,1,5,1979,1970,1980,6,3
195,AB-17,196,1,4,1981,1980,1982,6,3
196,AB-17,197,1,4,1997,1990,1998,6,3
197,AB-17,198,1,6,2008,2000,2009,6,3
198,AB-18,199,1,5,1928,1920,1929,8,3
199,AB-18,200,1,4,1961,1960,1962,8,3
200,AB-18,201,1,3,1971,1970,1972,8,3
201,AB-18,202,2,4,1973,1970,1975,8,3
202,AB-18,203,1,3,1976,1970,1977,8,3
203,AB-18,204,3,6,1978,1970,1981,8,3
204,AB-18,205,2,6,1983,1980,1985,8,3
205,AB-18,206,1,5,1986,1980,1987,8,3
206,AB-18,207,3,3,1990,1990,1993,8,3
207,AB-18,208,3,8,1994,1990,1997,8,3
208,AB-18,209,2,7,1999,1990,2001,8,3
209,AB-18,210,3,5,2003,2000,2006,8,3
210,AB-18,211,1,3,2007,2000,2008,8,3
211,AB-18,212,1,3,2009,2000,2010,8,3
212,AB-18,213,2,3,2015,2010,2017,8,3
213,AB-21,214,1,4,2006,2000,2007,4,3
214,AB-21,215,1,3,2008,2000,2009,4,3
215,AB-22,216,1,4,2001,2000,2002,4,4
216,AB-23,217,1,3,1999,1990,2000,4,3
217,AB-23,218,1,4,2012,2010,2013,4,3
218,AB-24,219,1,5,1994,1990,1995,8,3
219,AB-24,220,3,8,1996,1990,1999,8,3
220,AB-24,221,1,3,2001,2000,2002,8,3
221,AB-24,222,1,4,2003,2000,2004,8,3
222,AB-24,223,2,4,2005,2000,2007,8,3
223,AB-24,224,5,6,2008,2000,2013,8,3
224,AB-24,225,1,4,2014,2010,2015,8,3
225,AB-25,226,1,3,1995,1990,1996,5,3
226,AB-25,227,2,5,1997,1990,1999,5,3
227,AB-25,228,2,3,2011,2010,2013,5,3
228,AB-25,229,1,3,2014,2010,2015,5,3
229,AB-25,230,1,3,2016,2010,2017,5,3
230,AB-26,231,1,5,2010,2010,2011,5,5
231,AB-3,232,1,3,2007,2000,2008,3,3
232,AB-5,233,1,4,1992,1990,1993,4,4
233,AB-6,234,1,5,1993,1990,1994,5,5
234,AB-8,235,1,3,2000,2000,2001,3,3
235,AC-1,236,1,3,1991,1990,1992,3,3
236,AC-10,237,1,3,1984,1980,1985,4,3
237,AC-10,238,1,4,1996,1990,1997,4,3
238,AC-11,239,2,6,1973,1970,1975,9,3
239,AC-11,240,4,6,1976,1970,1980,9,3
240,AC-11,241,5,9,1981,1980,1986,9,3
241,AC-11,242,2,6,1990,1990,1992,9,3
242,AC-11,243,1,3,1998,1990,1999,9,3
243,AC-11,244,1,3,2003,2000,2004,9,3
244,AC-11,245,1,4,2009,2000,2010,9,3
245,AC-12,246,1,4,1929,1920,1930,9,3
246,AC-12,247,12,9,1972,1970,1984,9,3
247,AC-12,248,1,3,1985,1980,1986,9,3
248,AC-12,249,2,6,1988,1980,1990,9,3
249,AC-12,250,1,3,1993,1990,1994,9,3
250,AC-12,251,1,3,1995,1990,1996,9,3
251,AC-12,252,3,5,1999,1990,2002,9,3
252,AC-13,253,1,4,1981,1980,1982,4,3
253,AC-13,254,1,3,1983,1980,1984,4,3
254,AC-14,255,1,3,1922,1920,1923,11,3
255,AC-14,256,6,11,1925,1920,1931,11,3
256,AC-14,257,2,4,1946,1940,1948,11,3
257,AC-14,258,7,9,1950,1950,1957,11,3
258,AC-14,259,1,4,1958,1950,1959,11,3
259,AC-14,260,2,7,1960,1960,1962,11,3
260,AC-14,261,1,3,1963,1960,1964,11,3
261,AC-14,262,1,4,1966,1960,1967,11,3
262,AC-14,263,26,11,1968,1960,1994,11,3
263,AC-14,264,3,6,1996,1990,1999,11,3
264,AC-14,265,2,5,2002,2000,2004,11,3
265,AC-15,266,2,7,1924,1920,1926,10,3
266,AC-15,267,2,7,1927,1920,1929,10,3
267,AC-15,268,1,3,1943,1940,1944,10,3
268,AC-15,269,1,3,1955,1950,1956,10,3
269,AC-15,270,1,3,1959,1950,1960,10,3
270,AC-15,271,1,3,1967,1960,1968,10,3
271,AC-15,272,6,9,1971,1970,1977,10,3
272,AC-15,273,3,8,1978,1970,1981,10,3
273,AC-15,274,3,10,1982,1980,1985,10,3
274,AC-15,275,1,4,1987,1980,1988,10,3
275,AC-15,276,7,8,1989,1980,1996,10,3
276,AC-15,277,2,7,1997,1990,1999,10,3
277,AC-15,278,1,4,2000,2000,2001,10,3
278,AC-15,279,2,4,2002,2000,2004,10,3
279,AC-15,280,1,4,2008,2000,2009,10,3
280,AC-15,281,2,5,2011,2010,2013,10,3
281,AC-15,282,1,3,2014,2010,2015,10,3
282,AC-16,283,1,3,1928,1920,1929,5,3
283,AC-16,284,1,3,1973,1970,1974,5,3
284,AC-16,285,1,3,1977,1970,1978,5,3
285,AC-16,286,2,5,1984,1980,1986,5,3
286,AC-16,287,1,4,1996,1990,1997,5,3
287,AC-17,288,2,3,1928,1920,1930,5,3
288,AC-17,289,1,3,1976,1970,1977,5,3
289,AC-17,290,1,3,1981,1980,1982,5,3
290,AC-17,291,2,5,1985,1980,1987,5,3
291,AC-17,292,1,4,1989,1980,1990,5,3
292,AC-17,293,2,4,1999,1990,2001,5,3
293,AC-17,294,2,4,2002,2000,2004,5,3
294,AC-18,295,1,3,1979,1970,1980,3,3
295,AC-18,296,1,3,2002,2000,2003,3,3
296,AC-19,297,1,3,2010,2010,2011,3,3
297,AC-20,298,1,4,2001,2000,2002,4,4
298,AC-21,299,1,3,1997,1990,1998,4,3
299,AC-21,300,1,4,2011,2010,2012,4,3
300,AC-21,301,1,4,2016,2010,2017,4,3
301,AC-22,302,2,3,1995,1990,1997,3,3
302,AC-22,303,1,3,2014,2010,2015,3,3
303,AC-23,304,1,3,1930,1930,1931,9,3
304,AC-23,305,1,4,1995,1990,1996,9,3
305,AC-23,306,1,3,1997,1990,1998,9,3
306,AC-23,307,1,5,2002,2000,2003,9,3
307,AC-23,308,1,3,2005,2000,2006,9,3
308,AC-23,309,1,3,2009,2000,2010,9,3
309,AC-23,310,1,3,2013,2010,2014,9,3
310,AC-23,311,2,9,2015,2010,2017,9,3
311,AC-24,312,1,4,1921,1920,1922,8,3
312,AC-24,313,1,3,1982,1980,1983,8,3
313,AC-24,314,1,4,1986,1980,1987,8,3
314,AC-24,315,1,5,1988,1980,1989,8,3
315,AC-24,316,5,8,1990,1990,1995,8,3
316,AC-24,317,2,4,1997,1990,1999,8,3
317,AC-24,318,1,7,2000,2000,2001,8,3
318,AC-24,319,2,3,2002,2000,2004,8,3
319,AC-24,320,1,7,2005,2000,2006,8,3
320,AC-24,321,2,4,2007,2000,2009,8,3
321,AC-24,322,2,5,2011,2010,2013,8,3
322,AC-24,323,1,4,2014,2010,2015,8,3
323,AC-25,324,2,4,1997,1990,1999,7,3
324,AC-25,325,4,7,2004,2000,2008,7,3
325,AC-25,326,2,3,2009,2000,2011,7,3
326,AC-25,327,1,4,2012,2010,2013,7,3
327,AC-25,328,3,4,2014,2010,2017,7,3
328,AC-26,329,1,4,1953,1950,1954,4,3
329,AC-26,330,1,3,2016,2010,2017,4,3
330,AC-3,331,1,3,2016,2010,2017,3,3
331,AC-6,332,1,3,1986,1980,1987,3,3
332,AC-7,333,1,3,1996,1990,1997,3,3
333,AD-10,334,1,3,1979,1970,1980,6,3
334,AD-10,335,1,3,1985,1980,1986,6,3
335,AD-10,336,1,3,1995,1990,1996,6,3
336,AD-10,337,1,4,1997,1990,1998,6,3
337,AD-10,338,1,6,2002,2000,2003,6,3
338,AD-11,339,1,3,1977,1970,1978,7,3
339,AD-11,340,2,7,1979,1970,1981,7,3
340,AD-11,341,1,3,1993,1990,1994,7,3
341,AD-12,342,2,3,1928,1920,1930,8,3
342,AD-12,343,2,4,1970,1970,1972,8,3
343,AD-12,344,14,8,1973,1970,1987,8,3
344,AD-12,345,1,3,1990,1990,1991,8,3
345,AD-12,346,1,4,1992,1990,1993,8,3
346,AD-13,347,1,6,1959,1950,1960,9,3
347,AD-13,348,1,3,1961,1960,1962,9,3
348,AD-13,349,1,3,1967,1960,1968,9,3
349,AD-13,350,1,3,1969,1960,1970,9,3
350,AD-13,351,1,9,1971,1970,1972,9,3
351,AD-13,352,3,4,1973,1970,1976,9,3
352,AD-13,353,3,4,1977,1970,1980,9,3
353,AD-13,354,1,6,1981,1980,1982,9,3
354,AD-13,355,2,6,1984,1980,1986,9,3
355,AD-13,356,2,4,1989,1980,1991,9,3
356,AD-13,357,1,4,1993,1990,1994,9,3
357,AD-14,358,1,3,1920,1920,1921,10,3
358,AD-14,359,2,3,1923,1920,1925,10,3
359,AD-14,360,4,5,1926,1920,1930,10,3
360,AD-14,361,1,3,1945,1940,1946,10,3
361,AD-14,362,1,3,1947,1940,1948,10,3
362,AD-14,363,1,4,1950,1950,1951,10,3
363,AD-14,364,1,4,1955,1950,1956,10,3
364,AD-14,365,1,3,1960,1960,1961,10,3
365,AD-14,366,2,6,1969,1960,1971,10,3
366,AD-14,367,4,6,1972,1970,1976,10,3
367,AD-14,368,3,6,1977,1970,1980,10,3
368,AD-14,369,11,10,1983,1980,1994,10,3
369,AD-14,370,1,4,1996,1990,1997,10,3
370,AD-15,371,1,3,1911,1910,1912,19,3
371,AD-15,372,3,7,1927,1920,1930,19,3
372,AD-15,373,3,7,1948,1940,1951,19,3
373,AD-15,374,3,9,1952,1950,1955,19,3
374,AD-15,375,25,19,1956,1950,1981,19,3
375,AD-15,376,1,3,1983,1980,1984,19,3
376,AD-15,377,2,6,1985,1980,1987,19,3
377,AD-15,378,1,3,1988,1980,1989,19,3
378,AD-15,379,2,5,1991,1990,1993,19,3
379,AD-15,380,1,4,1994,1990,1995,19,3
380,AD-15,381,2,3,1998,1990,2000,19,3
381,AD-15,382,1,3,2006,2000,2007,19,3
382,AD-15,383,2,3,2015,2010,2017,19,3
383,AD-16,384,1,5,1921,1920,1922,5,3
384,AD-16,385,2,3,1925,1920,1927,5,3
385,AD-16,386,2,3,1947,1940,1949,5,3
386,AD-16,387,1,3,1951,1950,1952,5,3
387,AD-16,388,1,3,1970,1970,1971,5,3
388,AD-16,389,1,3,1974,1970,1975,5,3
389,AD-16,390,1,3,1976,1970,1977,5,3
390,AD-16,391,1,4,1990,1990,1991,5,3
391,AD-17,392,1,3,1948,1940,1949,6,3
392,AD-17,393,2,3,1974,1970,1976,6,3
393,AD-17,394,1,4,1979,1970,1980,6,3
394,AD-17,395,5,6,1987,1980,1992,6,3
395,AD-17,396,1,5,1994,1990,1995,6,3
396,AD-17,397,1,3,1998,1990,1999,6,3
397,AD-17,398,1,3,2002,2000,2003,6,3
398,AD-17,399,1,3,2016,2010,2017,6,3
399,AD-18,400,1,4,1925,1920,1926,6,3
400,AD-18,401,1,3,1975,1970,1976,6,3
401,AD-18,402,1,3,1977,1970,1978,6,3
402,AD-18,403,1,5,1980,1980,1981,6,3
403,AD-18,404,2,3,1985,1980,1987,6,3
404,AD-18,405,2,6,1994,1990,1996,6,3
405,AD-18,406,1,3,2000,2000,2001,6,3
406,AD-18,407,1,3,2012,2010,2013,6,3
407,AD-2,408,1,4,1991,1990,1992,4,3
408,AD-2,409,2,3,1993,1990,1995,4,3
409,AD-2,410,1,4,1996,1990,1997,4,3
410,AD-2,411,1,3,2002,2000,2003,4,3
411,AD-2,412,1,3,2008,2000,2009,4,3
412,AD-20,413,1,3,1996,1990,1997,3,3
413,AD-22,414,1,3,1999,1990,2000,3,3
414,AD-22,415,1,3,2008,2000,2009,3,3
415,AD-23,416,1,3,1982,1980,1983,6,3
416,AD-23,417,1,3,1986,1980,1987,6,3
417,AD-23,418,1,5,1989,1980,1990,6,3
418,AD-23,419,1,4,1994,1990,1995,6,3
419,AD-23,420,2,4,1996,1990,1998,6,3
420,AD-23,421,1,3,2002,2000,2003,6,3
421,AD-23,422,2,6,2006,2000,2008,6,3
422,AD-23,423,3,4,2012,2010,2015,6,3
423,AD-24,424,1,3,1987,1980,1988,3,3
424,AD-24,425,1,3,1990,1990,1991,3,3
425,AD-25,426,1,3,1980,1980,1981,5,3
426,AD-25,427,3,3,1990,1990,1993,5,3
427,AD-25,428,1,4,1994,1990,1995,5,3
428,AD-25,429,1,3,1997,1990,1998,5,3
429,AD-25,430,3,3,2002,2000,2005,5,3
430,AD-25,431,1,5,2006,2000,2007,5,3
431,AD-25,432,1,3,2008,2000,2009,5,3
432,AD-25,433,1,5,2011,2010,2012,5,3
433,AD-25,434,1,4,2014,2010,2015,5,3
434,AD-25,435,1,4,2016,2010,2017,5,3
435,AD-26,436,1,5,1991,1990,1992,6,3
436,AD-26,437,2,6,1994,1990,1996,6,3
437,AD-26,438,1,4,1997,1990,1998,6,3
438,AD-26,439,1,4,2000,2000,2001,6,3
439,AD-26,440,1,3,2002,2000,2003,6,3
440,AD-26,441,1,6,2006,2000,2007,6,3
441,AD-26,442,1,3,2009,2000,2010,6,3
442,AD-26,443,3,5,2012,2010,2015,6,3
443,AD-33,444,1,3,2010,2010,2011,3,3
444,AD-6,445,1,7,1976,1970,1977,7,3
445,AD-6,446,1,3,1986,1980,1987,7,3
446,AD-9,447,1,3,1958,1950,1959,3,3
447,AD-9,448,1,3,1974,1970,1975,3,3
448,AD-9,449,1,3,1978,1970,1979,3,3
449,AE-1,450,2,4,1975,1970,1977,6,3
450,AE-1,451,2,3,1979,1970,1981,6,3
451,AE-1,452,1,3,1982,1980,1983,6,3
452,AE-1,453,2,4,1985,1980,1987,6,3
453,AE-1,454,1,3,1989,1980,1990,6,3
454,AE-1,455,7,6,1992,1990,1999,6,3
455,AE-1,456,1,5,2000,2000,2001,6,3
456,AE-1,457,1,4,2002,2000,2003,6,3
457,AE-1,458,1,3,2011,2010,2012,6,3
458,AE-1,459,3,4,2013,2010,2016,6,3
459,AE-11,460,1,3,1987,1980,1988,3,3
460,AE-11,461,1,3,1993,1990,1994,3,3
461,AE-12,462,1,3,1883,1880,1884,11,3
462,AE-12,463,1,4,1900,1900,1901,11,3
463,AE-12,464,2,3,1908,1900,1910,11,3
464,AE-12,465,2,3,1915,1910,1917,11,3
465,AE-12,466,1,3,1930,1930,1931,11,3
466,AE-12,467,1,3,1961,1960,1962,11,3
467,AE-12,468,1,4,1964,1960,1965,11,3
468,AE-12,469,1,3,1966,1960,1967,11,3
469,AE-12,470,1,6,1968,1960,1969,11,3
470,AE-12,471,17,11,1970,1970,1987,11,3
471,AE-12,472,3,7,1989,1980,1992,11,3
472,AE-12,473,2,5,1994,1990,1996,11,3
473,AE-12,474,1,8,1997,1990,1998,11,3
474,AE-12,475,1,5,2001,2000,2002,11,3
475,AE-12,476,1,4,2004,2000,2005,11,3
476,AE-13,477,2,3,1921,1920,1923,7,3
477,AE-13,478,1,3,1926,1920,1927,7,3
478,AE-13,479,2,4,1929,1920,1931,7,3
479,AE-13,480,1,7,1954,1950,1955,7,3
480,AE-13,481,1,3,1964,1960,1965,7,3
481,AE-13,482,1,3,1969,1960,1970,7,3
482,AE-13,483,1,3,1974,1970,1975,7,3
483,AE-13,484,1,7,1977,1970,1978,7,3
484,AE-13,485,1,6,1979,1970,1980,7,3
485,AE-13,486,1,4,1985,1980,1986,7,3
486,AE-13,487,3,4,1989,1980,1992,7,3
487,AE-13,488,1,3,2001,2000,2002,7,3
488,AE-13,489,1,3,2008,2000,2009,7,3
489,AE-14,490,1,4,1911,1910,1912,12,3
490,AE-14,491,1,3,1915,1910,1916,12,3
491,AE-14,492,1,4,1918,1910,1919,12,3
492,AE-14,493,1,3,1920,1920,1921,12,3
493,AE-14,494,20,9,1922,1920,1942,12,3
494,AE-14,495,1,5,1946,1940,1947,12,3
495,AE-14,496,9,9,1949,1940,1958,12,3
496,AE-14,497,4,8,1959,1950,1963,12,3
497,AE-14,498,16,12,1965,1960,1981,12,3
498,AE-14,499,2,7,1982,1980,1984,12,3
499,AE-14,500,5,7,1985,1980,1990,12,3
500,AE-14,501,1,5,1991,1990,1992,12,3
501,AE-14,502,3,6,1993,1990,1996,12,3
502,AE-14,503,1,6,1997,1990,1998,12,3
503,AE-14,504,1,3,1999,1990,2000,12,3
504,AE-15,505,1,3,1902,1900,1903,10,3
505,AE-15,506,1,3,1915,1910,1916,10,3
506,AE-15,507,1,4,1918,1910,1919,10,3
507,AE-15,508,2,4,1921,1920,1923,10,3
508,AE-15,509,2,7,1924,1920,1926,10,3
509,AE-15,510,1,10,1928,1920,1929,10,3
510,AE-15,511,1,5,1941,1940,1942,10,3
511,AE-15,512,1,3,1944,1940,1945,10,3
512,AE-15,513,3,4,1946,1940,1949,10,3
513,AE-15,514,1,3,1952,1950,1953,10,3
514,AE-15,515,1,3,1959,1950,1960,10,3
515,AE-15,516,1,3,1962,1960,1963,10,3
516,AE-15,517,1,4,1970,1970,1971,10,3
517,AE-15,518,2,3,1974,1970,1976,10,3
518,AE-15,519,1,4,1979,1970,1980,10,3
519,AE-15,520,1,3,1985,1980,1986,10,3
520,AE-16,521,1,3,1922,1920,1923,12,3
521,AE-16,522,3,4,1924,1920,1927,12,3
522,AE-16,523,1,6,1930,1930,1931,12,3
523,AE-16,524,1,3,1941,1940,1942,12,3
524,AE-16,525,1,5,1944,1940,1945,12,3
525,AE-16,526,3,9,1947,1940,1950,12,3
526,AE-16,527,2,7,1951,1950,1953,12,3
527,AE-16,528,1,3,1954,1950,1955,12,3
528,AE-16,529,2,5,1957,1950,1959,12,3
529,AE-16,530,3,7,1960,1960,1963,12,3
530,AE-16,531,1,4,1964,1960,1965,12,3
531,AE-16,532,2,4,1966,1960,1968,12,3
532,AE-16,533,3,11,1969,1960,1972,12,3
533,AE-16,534,9,12,1973,1970,1982,12,3
534,AE-16,535,3,4,1983,1980,1986,12,3
535,AE-16,536,6,9,1988,1980,1994,12,3
536,AE-16,537,1,3,1996,1990,1997,12,3
537,AE-16,538,2,4,1999,1990,2001,12,3
538,AE-17,539,1,3,1902,1900,1903,7,3
539,AE-17,540,1,3,1916,1910,1917,7,3
540,AE-17,541,1,4,1925,1920,1926,7,3
541,AE-17,542,1,3,1929,1920,1930,7,3
542,AE-17,543,1,3,1972,1970,1973,7,3
543,AE-17,544,1,3,1975,1970,1976,7,3
544,AE-17,545,1,4,1977,1970,1978,7,3
545,AE-17,546,2,3,1979,1970,1981,7,3
546,AE-17,547,3,5,1985,1980,1988,7,3
547,AE-17,548,1,4,1989,1980,1990,7,3
548,AE-17,549,1,3,1991,1990,1992,7,3
549,AE-17,550,1,5,1993,1990,1994,7,3
550,AE-17,551,3,7,1997,1990,2000,7,3
551,AE-17,552,1,3,2001,2000,2002,7,3
552,AE-19,553,1,4,1921,1920,1922,4,3
553,AE-19,554,1,3,1995,1990,1996,4,3
554,AE-2,555,1,4,1977,1970,1978,7,4
555,AE-2,556,1,4,1985,1980,1986,7,4
556,AE-2,557,7,7,1987,1980,1994,7,4
557,AE-2,558,2,6,1995,1990,1997,7,4
558,AE-2,559,4,4,1998,1990,2002,7,4
559,AE-21,560,1,3,1900,1900,1901,13,3
560,AE-21,561,1,3,1908,1900,1909,13,3
561,AE-21,562,1,3,1911,1910,1912,13,3
562,AE-21,563,1,3,1916,1910,1917,13,3
563,AE-21,564,1,4,1919,1910,1920,13,3
564,AE-21,565,2,4,1921,1920,1923,13,3
565,AE-21,566,2,4,1928,1920,1930,13,3
566,AE-21,567,1,3,1942,1940,1943,13,3
567,AE-21,568,1,3,1956,1950,1957,13,3
568,AE-21,569,2,4,1974,1970,1976,13,3
569,AE-21,570,2,3,1977,1970,1979,13,3
570,AE-21,571,3,4,1983,1980,1986,13,3
571,AE-21,572,1,5,1988,1980,1989,13,3
572,AE-21,573,2,4,1990,1990,1992,13,3
573,AE-21,574,3,5,1993,1990,1996,13,3
574,AE-21,575,2,7,1998,1990,2000,13,3
575,AE-21,576,2,8,2001,2000,2003,13,3
576,AE-21,577,1,3,2004,2000,2005,13,3
577,AE-21,578,1,4,2008,2000,2009,13,3
578,AE-21,579,3,5,2011,2010,2014,13,3
579,AE-21,580,2,13,2015,2010,2017,13,3
580,AE-22,581,1,3,1930,1930,1931,11,3
581,AE-22,582,1,3,1980,1980,1981,11,3
582,AE-22,583,13,11,1986,1980,1999,11,3
583,AE-22,584,2,5,2000,2000,2002,11,3
584,AE-22,585,1,4,2003,2000,2004,11,3
585,AE-22,586,1,3,2005,2000,2006,11,3
586,AE-22,587,3,4,2007,2000,2010,11,3
587,AE-22,588,1,3,2011,2010,2012,11,3
588,AE-22,589,1,4,2016,2010,2017,11,3
589,AE-23,590,3,4,1976,1970,1979,14,3
590,AE-23,591,1,4,1980,1980,1981,14,3
591,AE-23,592,1,6,1982,1980,1983,14,3
592,AE-23,593,1,5,1984,1980,1985,14,3
593,AE-23,594,13,14,1987,1980,2000,14,3
594,AE-23,595,1,4,2001,2000,2002,14,3
595,AE-23,596,2,5,2003,2000,2005,14,3
596,AE-23,597,1,5,2006,2000,2007,14,3
597,AE-23,598,3,4,2008,2000,2011,14,3
598,AE-23,599,1,3,2014,2010,2015,14,3
599,AE-23,600,1,6,2016,2010,2017,14,3
600,AE-24,601,1,4,1969,1960,1970,8,4
601,AE-24,602,10,7,1972,1970,1982,8,4
602,AE-24,603,1,4,1985,1980,1986,8,4
603,AE-24,604,7,8,1990,1990,1997,8,4
604,AE-24,605,1,6,2000,2000,2001,8,4
605,AE-24,606,4,6,2002,2000,2006,8,4
606,AE-24,607,2,7,2007,2000,2009,8,4
607,AE-24,608,2,5,2010,2010,2012,8,4
608,AE-24,609,1,5,2013,2010,2014,8,4
609,AE-24,610,1,4,2016,2010,2017,8,4
610,AE-25,611,1,3,1916,1910,1917,7,3
611,AE-25,612,2,4,1974,1970,1976,7,3
612,AE-25,613,1,3,1978,1970,1979,7,3
613,AE-25,614,2,4,1982,1980,1984,7,3
614,AE-25,615,12,7,1986,1980,1998,7,3
615,AE-25,616,1,4,2000,2000,2001,7,3
616,AE-25,617,1,6,2002,2000,2003,7,3
617,AE-25,618,2,5,2009,2000,2011,7,3
618,AE-25,619,1,6,2016,2010,2017,7,3
619,AE-26,620,1,3,1976,1970,1977,5,3
620,AE-26,621,1,3,1982,1980,1983,5,3
621,AE-26,622,1,5,1991,1990,1992,5,3
622,AE-26,623,2,3,1993,1990,1995,5,3
623,AE-26,624,1,3,1996,1990,1997,5,3
624,AE-26,625,1,3,1998,1990,1999,5,3
625,AE-26,626,1,3,2012,2010,2013,5,3
626,AE-26,627,1,4,2014,2010,2015,5,3
627,AE-26,628,1,3,2016,2010,2017,5,3
628,AE-27,629,1,4,1975,1970,1976,5,3
629,AE-27,630,1,3,1983,1980,1984,5,3
630,AE-27,631,1,4,1986,1980,1987,5,3
631,AE-27,632,1,3,1988,1980,1989,5,3
632,AE-27,633,1,3,1991,1990,1992,5,3
633,AE-27,634,5,5,1993,1990,1998,5,3
634,AE-27,635,1,4,2001,2000,2002,5,3
635,AE-27,636,2,4,2008,2000,2010,5,3
636,AE-27,637,2,3,2015,2010,2017,5,3
637,AE-28,638,1,3,1981,1980,1982,6,3
638,AE-28,639,2,6,2010,2010,2012,6,3
639,AE-28,640,2,3,2015,2010,2017,6,3
640,AE-3,641,1,3,1979,1970,1980,3,3
641,AE-3,642,2,3,1986,1980,1988,3,3
642,AE-33,643,1,3,1991,1990,1992,4,3
643,AE-33,644,1,4,2001,2000,2002,4,3
644,AE-33,645,1,3,2012,2010,2013,4,3
645,AE-4,646,1,4,1993,1990,1994,4,4
646,AE-5,647,1,3,1976,1970,1977,4,3
647,AE-5,648,1,4,1983,1980,1984,4,3
648,AE-6,649,1,3,1970,1970,1971,4,3
649,AE-6,650,1,3,1982,1980,1983,4,3
650,AE-6,651,2,4,1984,1980,1986,4,3
651,AE-6,652,1,3,1988,1980,1989,4,3
652,AE-6,653,1,4,1994,1990,1995,4,3
653,AE-7,654,1,4,1976,1970,1977,4,4
654,AE-7,655,1,4,1983,1980,1984,4,4
655,AE-8,656,1,3,1927,1920,1928,4,3
656,AE-8,657,1,3,1973,1970,1974,4,3
657,AE-8,658,1,4,1976,1970,1977,4,3
658,AE-9,659,1,3,1991,1990,1992,3,3
659,AF-10,660,2,6,1973,1970,1975,6,6
660,AF-11,661,1,3,1926,1920,1927,3,3
661,AF-11,662,1,3,1960,1960,1961,3,3
662,AF-12,663,3,4,1899,1890,1902,4,3
663,AF-12,664,1,4,1903,1900,1904,4,3
664,AF-12,665,1,3,1907,1900,1908,4,3
665,AF-13,666,1,3,1902,1900,1903,8,3
666,AF-13,667,1,3,1912,1910,1913,8,3
667,AF-13,668,1,4,1921,1920,1922,8,3
668,AF-13,669,1,4,1925,1920,1926,8,3
669,AF-13,670,1,3,1969,1960,1970,8,3
670,AF-13,671,1,4,1971,1970,1972,8,3
671,AF-13,672,1,3,1974,1970,1975,8,3
672,AF-13,673,1,8,1977,1970,1978,8,3
673,AF-13,674,1,3,1982,1980,1983,8,3
674,AF-13,675,1,3,1985,1980,1986,8,3
675,AF-13,676,2,5,1994,1990,1996,8,3
676,AF-13,677,3,4,1998,1990,2001,8,3
677,AF-13,678,1,4,2003,2000,2004,8,3
678,AF-14,679,1,3,1900,1900,1901,6,3
679,AF-14,680,1,3,1916,1910,1917,6,3
680,AF-14,681,1,3,1921,1920,1922,6,3
681,AF-14,682,4,6,1923,1920,1927,6,3
682,AF-14,683,2,5,1928,1920,1930,6,3
683,AF-14,684,1,3,1973,1970,1974,6,3
684,AF-14,685,1,4,1978,1970,1979,6,3
685,AF-14,686,1,3,1986,1980,1987,6,3
686,AF-14,687,1,3,1992,1990,1993,6,3
687,AF-15,688,2,4,1909,1900,1911,10,3
688,AF-15,689,1,4,1914,1910,1915,10,3
689,AF-15,690,1,3,1921,1920,1922,10,3
690,AF-15,691,6,6,1923,1920,1929,10,3
691,AF-15,692,1,10,1930,1930,1931,10,3
692,AF-15,693,1,3,1941,1940,1942,10,3
693,AF-15,694,5,5,1946,1940,1951,10,3
694,AF-15,695,5,6,1952,1950,1957,10,3
695,AF-15,696,11,9,1958,1950,1969,10,3
696,AF-15,697,1,9,1970,1970,1971,10,3
697,AF-15,698,3,5,1972,1970,1975,10,3
698,AF-15,699,1,4,1976,1970,1977,10,3
699,AF-15,700,1,3,1979,1970,1980,10,3
700,AF-15,701,2,3,1981,1980,1983,10,3
701,AF-16,702,2,4,1918,1910,1920,9,3
702,AF-16,703,1,3,1921,1920,1922,9,3
703,AF-16,704,8,9,1923,1920,1931,9,3
704,AF-16,705,1,3,1944,1940,1945,9,3
705,AF-16,706,3,4,1947,1940,1950,9,3
706,AF-16,707,3,3,1955,1950,1958,9,3
707,AF-16,708,1,4,1960,1960,1961,9,3
708,AF-16,709,4,5,1963,1960,1967,9,3
709,AF-16,710,3,7,1970,1970,1973,9,3
710,AF-16,711,23,9,1974,1970,1997,9,3
711,AF-16,712,1,4,1998,1990,1999,9,3
712,AF-16,713,5,5,2000,2000,2005,9,3
713,AF-16,714,1,5,2006,2000,2007,9,3
714,AF-16,715,1,4,2009,2000,2010,9,3
715,AF-16,716,2,7,2011,2010,2013,9,3
716,AF-16,717,1,3,2016,2010,2017,9,3
717,AF-17,718,1,3,1921,1920,1922,12,3
718,AF-17,719,1,6,1923,1920,1924,12,3
719,AF-17,720,2,6,1925,1920,1927,12,3
720,AF-17,721,1,6,1961,1960,1962,12,3
721,AF-17,722,1,4,1963,1960,1964,12,3
722,AF-17,723,1,3,1966,1960,1967,12,3
723,AF-17,724,7,12,1968,1960,1975,12,3
724,AF-17,725,20,12,1976,1970,1996,12,3
725,AF-17,726,9,6,1997,1990,2006,12,3
726,AF-17,727,1,4,2009,2000,2010,12,3
727,AF-19,728,1,3,1903,1900,1904,3,3
728,AF-19,729,1,3,1929,1920,1930,3,3
729,AF-19,730,1,3,1977,1970,1978,3,3
730,AF-2,731,2,3,1987,1980,1989,3,3
731,AF-2,732,1,3,1991,1990,1992,3,3
732,AF-21,733,1,3,1925,1920,1926,6,3
733,AF-21,734,1,6,1928,1920,1929,6,3
734,AF-21,735,1,3,1930,1930,1931,6,3
735,AF-22,736,1,3,1918,1910,1919,8,3
736,AF-22,737,2,5,1928,1920,1930,8,3
737,AF-22,738,1,3,1950,1950,1951,8,3
738,AF-22,739,1,3,1982,1980,1983,8,3
739,AF-22,740,1,5,1984,1980,1985,8,3
740,AF-22,741,2,5,1986,1980,1988,8,3
741,AF-22,742,5,8,1989,1980,1994,8,3
742,AF-22,743,8,6,1996,1990,2004,8,3
743,AF-22,744,4,4,2005,2000,2009,8,3
744,AF-22,745,1,3,2010,2010,2011,8,3
745,AF-22,746,1,3,2012,2010,2013,8,3
746,AF-22,747,1,8,2016,2010,2017,8,3
747,AF-23,748,1,3,1970,1970,1971,11,3
748,AF-23,749,1,4,1973,1970,1974,11,3
749,AF-23,750,2,6,1977,1970,1979,11,3
750,AF-23,751,1,5,1980,1980,1981,11,3
751,AF-23,752,1,4,1984,1980,1985,11,3
752,AF-23,753,9,11,1986,1980,1995,11,3
753,AF-23,754,3,5,1996,1990,1999,11,3
754,AF-23,755,4,4,2000,2000,2004,11,3
755,AF-23,756,1,5,2005,2000,2006,11,3
756,AF-23,757,1,3,2007,2000,2008,11,3
757,AF-23,758,1,4,2010,2010,2011,11,3
758,AF-23,759,3,4,2012,2010,2015,11,3
759,AF-23,760,1,5,2016,2010,2017,11,3
760,AF-24,761,1,3,1929,1920,1930,8,3
761,AF-24,762,1,5,1970,1970,1971,8,3
762,AF-24,763,6,8,1972,1970,1978,8,3
763,AF-24,764,1,5,1981,1980,1982,8,3
764,AF-24,765,1,6,1987,1980,1988,8,3
765,AF-24,766,5,6,1989,1980,1994,8,3
766,AF-24,767,9,6,1995,1990,2004,8,3
767,AF-24,768,1,5,2005,2000,2006,8,3
768,AF-24,769,4,5,2009,2000,2013,8,3
769,AF-25,770,1,3,1925,1920,1926,12,3
770,AF-25,771,1,3,1928,1920,1929,12,3
771,AF-25,772,3,12,1968,1960,1971,12,3
772,AF-25,773,3,7,1972,1970,1975,12,3
773,AF-25,774,2,5,1980,1980,1982,12,3
774,AF-25,775,1,4,1983,1980,1984,12,3
775,AF-25,776,1,4,1986,1980,1987,12,3
776,AF-25,777,1,4,1989,1980,1990,12,3
777,AF-25,778,6,6,1991,1990,1997,12,3
778,AF-25,779,1,3,1998,1990,1999,12,3
779,AF-25,780,1,4,2000,2000,2001,12,3
780,AF-25,781,1,4,2003,2000,2004,12,3
781,AF-25,782,1,4,2008,2000,2009,12,3
782,AF-25,783,1,6,2011,2010,2012,12,3
783,AF-25,784,3,5,2014,2010,2017,12,3
784,AF-26,785,3,5,1969,1960,1972,8,3
785,AF-26,786,1,4,1974,1970,1975,8,3
786,AF-26,787,2,4,1976,1970,1978,8,3
787,AF-26,788,2,3,1979,1970,1981,8,3
788,AF-26,789,1,3,1985,1980,1986,8,3
789,AF-26,790,5,8,1988,1980,1993,8,3
790,AF-26,791,2,5,1996,1990,1998,8,3
791,AF-26,792,3,4,2000,2000,2003,8,3
792,AF-26,793,1,4,2005,2000,2006,8,3
793,AF-26,794,2,5,2007,2000,2009,8,3
794,AF-26,795,5,6,2010,2010,2015,8,3
795,AF-26,796,1,7,2016,2010,2017,8,3
796,AF-27,797,1,3,1971,1970,1972,6,3
797,AF-27,798,2,5,1973,1970,1975,6,3
798,AF-27,799,1,3,1984,1980,1985,6,3
799,AF-27,800,1,4,1986,1980,1987,6,3
800,AF-27,801,4,6,1989,1980,1993,6,3
801,AF-27,802,1,3,1996,1990,1997,6,3
802,AF-27,803,1,3,1998,1990,1999,6,3
803,AF-27,804,1,3,2003,2000,2004,6,3
804,AF-27,805,3,4,2006,2000,2009,6,3
805,AF-27,806,1,5,2012,2010,2013,6,3
806,AF-28,807,1,4,1974,1970,1975,8,3
807,AF-28,808,1,3,1984,1980,1985,8,3
808,AF-28,809,1,3,1987,1980,1988,8,3
809,AF-28,810,2,4,1989,1980,1991,8,3
810,AF-28,811,3,8,1992,1990,1995,8,3
811,AF-28,812,1,3,1996,1990,1997,8,3
812,AF-28,813,2,4,1998,1990,2000,8,3
813,AF-28,814,1,3,2002,2000,2003,8,3
814,AF-28,815,1,3,2016,2010,2017,8,3
815,AF-29,816,1,3,1975,1970,1976,8,3
816,AF-29,817,1,3,1980,1980,1981,8,3
817,AF-29,818,2,5,1983,1980,1985,8,3
818,AF-29,819,1,4,1988,1980,1989,8,3
819,AF-29,820,1,3,1990,1990,1991,8,3
820,AF-29,821,4,4,1993,1990,1997,8,3
821,AF-29,822,1,4,1998,1990,1999,8,3
822,AF-29,823,1,3,2000,2000,2001,8,3
823,AF-29,824,1,5,2003,2000,2004,8,3
824,AF-29,825,1,4,2006,2000,2007,8,3
825,AF-29,826,2,5,2010,2010,2012,8,3
826,AF-29,827,1,5,2013,2010,2014,8,3
827,AF-29,828,1,8,2016,2010,2017,8,3
828,AF-3,829,1,4,1975,1970,1976,4,3
829,AF-3,830,1,3,1979,1970,1980,4,3
830,AF-3,831,1,3,1998,1990,1999,4,3
831,AF-30,832,1,3,1972,1970,1973,4,3
832,AF-30,833,1,4,1999,1990,2000,4,3
833,AF-30,834,1,3,2006,2000,2007,4,3
834,AF-31,835,1,3,1986,1980,1987,3,3
835,AF-33,836,1,3,1969,1960,1970,4,3
836,AF-33,837,1,3,1973,1970,1974,4,3
837,AF-33,838,1,3,1989,1980,1990,4,3
838,AF-33,839,1,3,1995,1990,1996,4,3
839,AF-33,840,1,4,2010,2010,2011,4,3
840,AF-34,841,1,3,1993,1990,1994,3,3
841,AF-34,842,1,3,1999,1990,2000,3,3
842,AF-4,843,1,24,1976,1970,1977,24,3
843,AF-4,844,1,3,1978,1970,1979,24,3
844,AF-4,845,1,3,1980,1980,1981,24,3
845,AF-4,846,1,4,1984,1980,1985,24,3
846,AF-4,847,2,5,1986,1980,1988,24,3
847,AF-4,848,3,7,1989,1980,1992,24,3
848,AF-4,849,1,4,1994,1990,1995,24,3
849,AF-4,850,1,3,2000,2000,2001,24,3
850,AF-5,851,1,4,1930,1930,1931,14,3
851,AF-5,852,1,4,1968,1960,1969,14,3
852,AF-5,853,1,3,1971,1970,1972,14,3
853,AF-5,854,5,5,1973,1970,1978,14,3
854,AF-5,855,3,14,1979,1970,1982,14,3
855,AF-5,856,2,6,1983,1980,1985,14,3
856,AF-5,857,1,3,1986,1980,1987,14,3
857,AF-5,858,2,3,1990,1990,1992,14,3
858,AF-5,859,1,5,1994,1990,1995,14,3
859,AF-6,860,1,3,1924,1920,1925,10,3
860,AF-6,861,1,4,1930,1930,1931,10,3
861,AF-6,862,1,3,1942,1940,1943,10,3
862,AF-6,863,1,5,1956,1950,1957,10,3
863,AF-6,864,2,4,1961,1960,1963,10,3
864,AF-6,865,13,9,1966,1960,1979,10,3
865,AF-6,866,4,10,1980,1980,1984,10,3
866,AF-6,867,9,8,1985,1980,1994,10,3
867,AF-6,868,1,3,2001,2000,2002,10,3
868,AF-6,869,1,4,2003,2000,2004,10,3
869,AF-6,870,1,3,2015,2010,2016,10,3
870,AF-7,871,1,3,1960,1960,1961,11,3
871,AF-7,872,17,11,1967,1960,1984,11,3
872,AF-7,873,4,9,1985,1980,1989,11,3
873,AF-7,874,3,7,1990,1990,1993,11,3
874,AF-7,875,4,5,1994,1990,1998,11,3
875,AF-7,876,2,3,2014,2010,2016,11,3
876,AF-8,877,1,4,1926,1920,1927,4,3
877,AF-8,878,1,3,1967,1960,1968,4,3
878,AF-8,879,1,4,1973,1970,1974,4,3
879,AF-8,880,1,3,1978,1970,1979,4,3
880,AF-9,881,1,3,1923,1920,1924,4,3
881,AF-9,882,1,3,1929,1920,1930,4,3
882,AF-9,883,1,3,1970,1970,1971,4,3
883,AF-9,884,1,3,1974,1970,1975,4,3
884,AF-9,885,1,3,1976,1970,1977,4,3
885,AF-9,886,1,3,1978,1970,1979,4,3
886,AF-9,887,1,4,1984,1980,1985,4,3
887,AG-10,888,1,3,1922,1920,1923,3,3
888,AG-10,889,1,3,1924,1920,1925,3,3
889,AG-10,890,1,3,1966,1960,1967,3,3
890,AG-11,891,1,4,1924,1920,1925,7,3
891,AG-11,892,1,3,1930,1930,1931,7,3
892,AG-11,893,2,7,1966,1960,1968,7,3
893,AG-11,894,3,7,1969,1960,1972,7,3
894,AG-11,895,4,6,1973,1970,1977,7,3
895,AG-11,896,1,3,1978,1970,1979,7,3
896,AG-11,897,1,3,1980,1980,1981,7,3
897,AG-11,898,1,3,2005,2000,2006,7,3
898,AG-12,899,1,3,1909,1900,1910,3,3
899,AG-12,900,1,3,1951,1950,1952,3,3
900,AG-12,901,1,3,2003,2000,2004,3,3
901,AG-13,902,1,3,1894,1890,1895,14,3
902,AG-13,903,4,5,1898,1890,1902,14,3
903,AG-13,904,3,3,1907,1900,1910,14,3
904,AG-13,905,1,3,1913,1910,1914,14,3
905,AG-13,906,1,3,1916,1910,1917,14,3
906,AG-13,907,3,5,1924,1920,1927,14,3
907,AG-13,908,1,3,1930,1930,1931,14,3
908,AG-13,909,1,10,1947,1940,1948,14,3
909,AG-13,910,1,3,1952,1950,1953,14,3
910,AG-13,911,2,14,1954,1950,1956,14,3
911,AG-13,912,1,3,1957,1950,1958,14,3
912,AG-13,913,1,5,1973,1970,1974,14,3
913,AG-13,914,1,3,1988,1980,1989,14,3
914,AG-13,915,1,3,1996,1990,1997,14,3
915,AG-14,916,1,3,1884,1880,1885,10,3
916,AG-14,917,1,6,1891,1890,1892,10,3
917,AG-14,918,5,5,1896,1890,1901,10,3
918,AG-14,919,3,10,1902,1900,1905,10,3
919,AG-14,920,2,5,1907,1900,1909,10,3
920,AG-14,921,4,7,1910,1910,1914,10,3
921,AG-14,922,2,6,1915,1910,1917,10,3
922,AG-14,923,4,6,1922,1920,1926,10,3
923,AG-14,924,3,10,1928,1920,1931,10,3
924,AG-14,925,1,3,1941,1940,1942,10,3
925,AG-14,926,3,5,1946,1940,1949,10,3
926,AG-14,927,2,3,1950,1950,1952,10,3
927,AG-14,928,1,4,1953,1950,1954,10,3
928,AG-14,929,1,5,1955,1950,1956,10,3
929,AG-14,930,1,3,1957,1950,1958,10,3
930,AG-14,931,12,8,1959,1950,1971,10,3
931,AG-14,932,1,4,1972,1970,1973,10,3
932,AG-14,933,3,4,1974,1970,1977,10,3
933,AG-14,934,2,4,1978,1970,1980,10,3
934,AG-14,935,1,3,2011,2010,2012,10,3
935,AG-15,936,1,3,1890,1890,1891,10,3
936,AG-15,937,1,3,1892,1890,1893,10,3
937,AG-15,938,1,5,1897,1890,1898,10,3
938,AG-15,939,2,4,1902,1900,1904,10,3
939,AG-15,940,1,6,1907,1900,1908,10,3
940,AG-15,941,4,3,1909,1900,1913,10,3
941,AG-15,942,12,10,1914,1910,1926,10,3
942,AG-15,943,3,9,1927,1920,1930,10,3
943,AG-15,944,1,3,1942,1940,1943,10,3
944,AG-15,945,1,4,1944,1940,1945,10,3
945,AG-15,946,3,4,1951,1950,1954,10,3
946,AG-15,947,1,3,1961,1960,1962,10,3
947,AG-15,948,1,3,1971,1970,1972,10,3
948,AG-16,949,1,3,1882,1880,1883,12,3
949,AG-16,950,1,3,1889,1880,1890,12,3
950,AG-16,951,1,4,1893,1890,1894,12,3
951,AG-16,952,1,3,1903,1900,1904,12,3
952,AG-16,953,1,3,1917,1910,1918,12,3
953,AG-16,954,2,8,1921,1920,1923,12,3
954,AG-16,955,18,12,1924,1920,1942,12,3
955,AG-16,956,2,6,1943,1940,1945,12,3
956,AG-16,957,31,10,1946,1940,1977,12,3
957,AG-16,958,3,7,1978,1970,1981,12,3
958,AG-16,959,1,5,1989,1980,1990,12,3
959,AG-16,960,2,3,1991,1990,1993,12,3
960,AG-16,961,1,5,2015,2010,2016,12,3
961,AG-17,962,1,3,1902,1900,1903,6,3
962,AG-17,963,1,3,1968,1960,1969,6,3
963,AG-17,964,3,4,1970,1970,1973,6,3
964,AG-17,965,1,4,1977,1970,1978,6,3
965,AG-17,966,1,6,1979,1970,1980,6,3
966,AG-17,967,3,4,1984,1980,1987,6,3
967,AG-17,968,1,3,1988,1980,1989,6,3
968,AG-17,969,2,3,1990,1990,1992,6,3
969,AG-17,970,1,4,1993,1990,1994,6,3
970,AG-17,971,4,4,1995,1990,1999,6,3
971,AG-18,972,1,3,1910,1910,1911,3,3
972,AG-18,973,1,3,1985,1980,1986,3,3
973,AG-19,974,1,3,1930,1930,1931,4,3
974,AG-19,975,1,3,1965,1960,1966,4,3
975,AG-19,976,1,3,1986,1980,1987,4,3
976,AG-19,977,1,4,1989,1980,1990,4,3
977,AG-19,978,1,3,1998,1990,1999,4,3
978,AG-21,979,1,3,1899,1890,1900,3,3
979,AG-22,980,1,3,1924,1920,1925,12,3
980,AG-22,981,1,3,1928,1920,1929,12,3
981,AG-22,982,1,3,1971,1970,1972,12,3
982,AG-22,983,1,3,1983,1980,1984,12,3
983,AG-22,984,1,6,1986,1980,1987,12,3
984,AG-22,985,9,12,1990,1990,1999,12,3
985,AG-22,986,4,7,2000,2000,2004,12,3
986,AG-22,987,1,3,2010,2010,2011,12,3
987,AG-22,988,2,6,2015,2010,2017,12,3
988,AG-23,989,1,3,1946,1940,1947,12,3
989,AG-23,990,1,3,1966,1960,1967,12,3
990,AG-23,991,3,7,1968,1960,1971,12,3
991,AG-23,992,5,6,1972,1970,1977,12,3
992,AG-23,993,1,6,1978,1970,1979,12,3
993,AG-23,994,1,5,1981,1980,1982,12,3
994,AG-23,995,16,9,1983,1980,1999,12,3
995,AG-23,996,4,12,2000,2000,2004,12,3
996,AG-23,997,2,4,2005,2000,2007,12,3
997,AG-23,998,1,4,2009,2000,2010,12,3
998,AG-23,999,6,12,2011,2010,2017,12,3
999,AG-24,1000,1,4,1925,1920,1926,13,3
1000,AG-24,1001,1,3,1943,1940,1944,13,3
1001,AG-24,1002,1,3,1947,1940,1948,13,3
1002,AG-24,1003,2,3,1955,1950,1957,13,3
1003,AG-24,1004,1,4,1961,1960,1962,13,3
1004,AG-24,1005,1,3,1964,1960,1965,13,3
1005,AG-24,1006,8,9,1967,1960,1975,13,3
1006,AG-24,1007,1,3,1976,1970,1977,13,3
1007,AG-24,1008,1,3,1980,1980,1981,13,3
1008,AG-24,1009,1,3,1982,1980,1983,13,3
1009,AG-24,1010,1,4,1984,1980,1985,13,3
1010,AG-24,1011,1,3,1988,1980,1989,13,3
1011,AG-24,1012,2,6,1991,1990,1993,13,3
1012,AG-24,1013,2,13,1994,1990,1996,13,3
1013,AG-24,1014,4,7,1997,1990,2001,13,3
1014,AG-24,1015,1,6,2003,2000,2004,13,3
1015,AG-24,1016,1,3,2014,2010,2015,13,3
1016,AG-24,1017,1,4,2016,2010,2017,13,3
1017,AG-25,1018,1,3,1962,1960,1963,11,3
1018,AG-25,1019,1,3,1967,1960,1968,11,3
1019,AG-25,1020,7,11,1969,1960,1976,11,3
1020,AG-25,1021,5,7,1977,1970,1982,11,3
1021,AG-25,1022,1,4,1983,1980,1984,11,3
1022,AG-25,1023,1,6,1986,1980,1987,11,3
1023,AG-25,1024,4,6,1988,1980,1992,11,3
1024,AG-25,1025,1,5,1993,1990,1994,11,3
1025,AG-25,1026,1,4,1996,1990,1997,11,3
1026,AG-25,1027,3,7,1998,1990,2001,11,3
1027,AG-25,1028,1,4,2002,2000,2003,11,3
1028,AG-25,1029,4,6,2004,2000,2008,11,3
1029,AG-25,1030,1,3,2009,2000,2010,11,3
1030,AG-25,1031,1,4,2011,2010,2012,11,3
1031,AG-25,1032,4,10,2013,2010,2017,11,3
1032,AG-26,1033,1,3,1964,1960,1965,10,3
1033,AG-26,1034,2,4,1970,1970,1972,10,3
1034,AG-26,1035,1,4,1978,1970,1979,10,3
1035,AG-26,1036,1,4,1980,1980,1981,10,3
1036,AG-26,1037,2,7,1991,1990,1993,10,3
1037,AG-26,1038,4,7,1994,1990,1998,10,3
1038,AG-26,1039,1,4,1999,1990,2000,10,3
1039,AG-26,1040,2,6,2004,2000,2006,10,3
1040,AG-26,1041,3,5,2007,2000,2010,10,3
1041,AG-26,1042,1,5,2013,2010,2014,10,3
1042,AG-26,1043,2,10,2015,2010,2017,10,3
1043,AG-27,1044,1,3,1968,1960,1969,8,3
1044,AG-27,1045,2,7,1970,1970,1972,8,3
1045,AG-27,1046,3,8,1973,1970,1976,8,3
1046,AG-27,1047,2,5,1977,1970,1979,8,3
1047,AG-27,1048,1,5,1980,1980,1981,8,3
1048,AG-27,1049,2,4,1982,1980,1984,8,3
1049,AG-27,1050,3,4,1986,1980,1989,8,3
1050,AG-27,1051,2,6,1990,1990,1992,8,3
1051,AG-27,1052,8,8,1993,1990,2001,8,3
1052,AG-27,1053,1,3,2008,2000,2009,8,3
1053,AG-27,1054,1,3,2010,2010,2011,8,3
1054,AG-27,1055,1,3,2014,2010,2015,8,3
1055,AG-27,1056,1,3,2016,2010,2017,8,3
1056,AG-28,1057,1,4,1971,1970,1972,4,3
1057,AG-28,1058,1,3,1974,1970,1975,4,3
1058,AG-28,1059,2,3,1980,1980,1982,4,3
1059,AG-28,1060,1,3,1989,1980,1990,4,3
1060,AG-28,1061,1,3,1992,1990,1993,4,3
1061,AG-28,1062,1,3,1994,1990,1995,4,3
1062,AG-28,1063,1,4,1997,1990,1998,4,3
1063,AG-28,1064,1,3,1999,1990,2000,4,3
1064,AG-28,1065,1,3,2007,2000,2008,4,3
1065,AG-28,1066,1,3,2010,2010,2011,4,3
1066,AG-28,1067,1,3,2013,2010,2014,4,3
1067,AG-29,1068,1,3,1975,1970,1976,3,3
1068,AG-29,1069,1,3,2007,2000,2008,3,3
1069,AG-29,1070,1,3,2009,2000,2010,3,3
1070,AG-30,1071,1,3,2006,2000,2007,3,3
1071,AG-30,1072,1,3,2016,2010,2017,3,3
1072,AG-31,1073,1,3,2002,2000,2003,3,3
1073,AG-31,1074,1,3,2007,2000,2008,3,3
1074,AG-32,1075,3,5,1993,1990,1996,5,5
1075,AG-33,1076,1,3,1972,1970,1973,7,3
1076,AG-33,1077,1,4,1986,1980,1987,7,3
1077,AG-33,1078,1,4,1991,1990,1992,7,3
1078,AG-33,1079,1,3,1993,1990,1994,7,3
1079,AG-33,1080,1,3,1998,1990,1999,7,3
1080,AG-33,1081,1,7,2000,2000,2001,7,3
1081,AG-33,1082,1,3,2009,2000,2010,7,3
1082,AG-33,1083,1,3,2014,2010,2015,7,3
1083,AG-34,1084,1,3,1992,1990,1993,3,3
1084,AG-4,1085,1,3,1990,1990,1991,3,3
1085,AG-5,1086,1,3,1970,1970,1971,3,3
1086,AG-6,1087,1,3,1925,1920,1926,11,3
1087,AG-6,1088,1,3,1928,1920,1929,11,3
1088,AG-6,1089,1,3,1930,1930,1931,11,3
1089,AG-6,1090,1,3,1953,1950,1954,11,3
1090,AG-6,1091,1,3,1956,1950,1957,11,3
1091,AG-6,1092,2,4,1960,1960,1962,11,3
1092,AG-6,1093,1,5,1964,1960,1965,11,3
1093,AG-6,1094,2,5,1966,1960,1968,11,3
1094,AG-6,1095,17,11,1969,1960,1986,11,3
1095,AG-6,1096,1,3,1987,1980,1988,11,3
1096,AG-6,1097,5,5,1989,1980,1994,11,3
1097,AG-6,1098,2,5,1995,1990,1997,11,3
1098,AG-6,1099,1,3,2001,2000,2002,11,3
1099,AG-6,1100,1,3,2007,2000,2008,11,3
1100,AG-6,1101,2,6,2015,2010,2017,11,3
1101,AG-7,1102,1,3,1953,1950,1954,13,3
1102,AG-7,1103,1,3,1961,1960,1962,13,3
1103,AG-7,1104,1,3,1963,1960,1964,13,3
1104,AG-7,1105,2,6,1966,1960,1968,13,3
1105,AG-7,1106,3,8,1969,1960,1972,13,3
1106,AG-7,1107,12,9,1974,1970,1986,13,3
1107,AG-7,1108,2,7,1987,1980,1989,13,3
1108,AG-7,1109,3,7,1990,1990,1993,13,3
1109,AG-7,1110,2,13,1994,1990,1996,13,3
1110,AG-7,1111,1,5,1997,1990,1998,13,3
1111,AG-8,1112,1,3,1928,1920,1929,7,3
1112,AG-8,1113,2,4,1969,1960,1971,7,3
1113,AG-8,1114,1,4,1973,1970,1974,7,3
1114,AG-8,1115,2,3,1975,1970,1977,7,3
1115,AG-8,1116,2,7,1979,1970,1981,7,3
1116,AG-8,1117,1,3,1982,1980,1983,7,3
1117,AG-8,1118,1,4,2007,2000,2008,7,3
1118,AG-9,1119,1,4,1922,1920,1923,7,3
1119,AG-9,1120,1,3,1925,1920,1926,7,3
1120,AG-9,1121,1,3,1928,1920,1929,7,3
1121,AG-9,1122,1,5,1930,1930,1931,7,3
1122,AG-9,1123,1,3,1964,1960,1965,7,3
1123,AG-9,1124,2,7,1972,1970,1974,7,3
1124,AG-9,1125,3,5,1977,1970,1980,7,3
1125,AG-9,1126,1,4,1981,1980,1982,7,3
1126,AH-10,1127,1,4,1929,1920,1930,5,3
1127,AH-10,1128,1,3,1944,1940,1945,5,3
1128,AH-10,1129,1,4,1961,1960,1962,5,3
1129,AH-10,1130,1,5,1977,1970,1978,5,3
1130,AH-10,1131,1,3,1981,1980,1982,5,3
1131,AH-10,1132,1,4,1984,1980,1985,5,3
1132,AH-10,1133,1,3,1989,1980,1990,5,3
1133,AH-11,1134,1,3,1900,1900,1901,7,3
1134,AH-11,1135,2,7,1929,1920,1931,7,3
1135,AH-11,1136,1,3,1942,1940,1943,7,3
1136,AH-11,1137,1,3,1948,1940,1949,7,3
1137,AH-11,1138,1,3,1953,1950,1954,7,3
1138,AH-11,1139,1,3,1960,1960,1961,7,3
1139,AH-11,1140,1,5,1963,1960,1964,7,3
1140,AH-11,1141,1,4,1970,1970,1971,7,3
1141,AH-12,1142,1,3,1911,1910,1912,10,3
1142,AH-12,1143,1,3,1913,1910,1914,10,3
1143,AH-12,1144,1,4,1917,1910,1918,10,3
1144,AH-12,1145,1,3,1925,1920,1926,10,3
1145,AH-12,1146,1,5,1928,1920,1929,10,3
1146,AH-12,1147,1,3,1954,1950,1955,10,3
1147,AH-12,1148,1,3,1959,1950,1960,10,3
1148,AH-12,1149,2,5,1961,1960,1963,10,3
1149,AH-12,1150,1,3,1964,1960,1965,10,3
1150,AH-12,1151,9,8,1966,1960,1975,10,3
1151,AH-12,1152,3,10,1977,1970,1980,10,3
1152,AH-12,1153,1,4,1981,1980,1982,10,3
1153,AH-12,1154,5,6,1983,1980,1988,10,3
1154,AH-12,1155,1,4,1994,1990,1995,10,3
1155,AH-12,1156,1,3,1998,1990,1999,10,3
1156,AH-12,1157,1,3,2001,2000,2002,10,3
1157,AH-13,1158,2,3,1894,1890,1896,14,3
1158,AH-13,1159,3,7,1901,1900,1904,14,3
1159,AH-13,1160,2,4,1908,1900,1910,14,3
1160,AH-13,1161,1,3,1911,1910,1912,14,3
1161,AH-13,1162,6,7,1913,1910,1919,14,3
1162,AH-13,1163,7,10,1920,1920,1927,14,3
1163,AH-13,1164,2,7,1928,1920,1930,14,3
1164,AH-13,1165,1,4,1941,1940,1942,14,3
1165,AH-13,1166,4,10,1947,1940,1951,14,3
1166,AH-13,1167,3,5,1953,1950,1956,14,3
1167,AH-13,1168,3,4,1960,1960,1963,14,3
1168,AH-13,1169,24,14,1966,1960,1990,14,3
1169,AH-13,1170,2,9,1991,1990,1993,14,3
1170,AH-13,1171,1,4,1994,1990,1995,14,3
1171,AH-13,1172,1,3,1996,1990,1997,14,3
1172,AH-13,1173,1,4,1998,1990,1999,14,3
1173,AH-13,1174,3,9,2000,2000,2003,14,3
1174,AH-13,1175,1,4,2004,2000,2005,14,3
1175,AH-14,1176,1,3,1880,1880,1881,8,3
1176,AH-14,1177,1,8,1886,1880,1887,8,3
1177,AH-14,1178,1,3,1900,1900,1901,8,3
1178,AH-15,1179,1,3,1875,1870,1876,7,3
1179,AH-15,1180,1,7,1882,1880,1883,7,3
1180,AH-15,1181,1,4,1885,1880,1886,7,3
1181,AH-15,1182,1,3,1890,1890,1891,7,3
1182,AH-15,1183,2,3,1892,1890,1894,7,3
1183,AH-15,1184,1,3,1895,1890,1896,7,3
1184,AH-15,1185,1,3,1898,1890,1899,7,3
1185,AH-15,1186,1,7,1900,1900,1901,7,3
1186,AH-15,1187,2,5,1903,1900,1905,7,3
1187,AH-15,1188,1,3,1909,1900,1910,7,3
1188,AH-15,1189,1,3,1913,1910,1914,7,3
1189,AH-15,1190,3,4,1916,1910,1919,7,3
1190,AH-15,1191,3,4,1921,1920,1924,7,3
1191,AH-15,1192,2,7,1925,1920,1927,7,3
1192,AH-15,1193,2,5,1929,1920,1931,7,3
1193,AH-15,1194,1,6,1948,1940,1949,7,3
1194,AH-15,1195,1,7,1956,1950,1957,7,3
1195,AH-15,1196,1,3,1962,1960,1963,7,3
1196,AH-15,1197,3,6,1966,1960,1969,7,3
1197,AH-15,1198,2,5,1970,1970,1972,7,3
1198,AH-15,1199,2,6,1973,1970,1975,7,3
1199,AH-15,1200,2,4,1978,1970,1980,7,3
1200,AH-15,1201,1,3,1982,1980,1983,7,3
1201,AH-15,1202,1,4,1999,1990,2000,7,3
1202,AH-15,1203,1,3,2006,2000,2007,7,3
1203,AH-16,1204,2,5,1893,1890,1895,7,3
1204,AH-16,1205,1,5,1898,1890,1899,7,3
1205,AH-16,1206,4,3,1900,1900,1904,7,3
1206,AH-16,1207,1,7,1908,1900,1909,7,3
1207,AH-16,1208,2,3,1919,1910,1921,7,3
1208,AH-16,1209,7,7,1922,1920,1929,7,3
1209,AH-16,1210,1,3,1943,1940,1944,7,3
1210,AH-16,1211,3,5,1946,1940,1949,7,3
1211,AH-16,1212,1,7,1953,1950,1954,7,3
1212,AH-16,1213,1,6,1955,1950,1956,7,3
1213,AH-16,1214,1,3,1957,1950,1958,7,3
1214,AH-17,1215,2,4,1892,1890,1894,6,3
1215,AH-17,1216,1,4,1914,1910,1915,6,3
1216,AH-17,1217,1,3,1920,1920,1921,6,3
1217,AH-17,1218,1,3,1924,1920,1925,6,3
1218,AH-17,1219,1,3,1930,1930,1931,6,3
1219,AH-17,1220,1,6,1950,1950,1951,6,3
1220,AH-17,1221,1,4,1970,1970,1971,6,3
1221,AH-17,1222,1,3,1975,1970,1976,6,3
1222,AH-17,1223,1,3,1984,1980,1985,6,3
1223,AH-17,1224,1,4,1993,1990,1994,6,3
1224,AH-17,1225,1,3,1997,1990,1998,6,3
1225,AH-18,1226,1,3,1886,1880,1887,5,3
1226,AH-18,1227,1,3,1913,1910,1914,5,3
1227,AH-18,1228,1,5,1923,1920,1924,5,3
1228,AH-18,1229,1,4,1928,1920,1929,5,3
1229,AH-18,1230,1,4,1930,1930,1931,5,3
1230,AH-19,1231,1,4,1913,1910,1914,4,3
1231,AH-19,1232,1,3,1928,1920,1929,4,3
1232,AH-19,1233,1,4,1930,1930,1931,4,3
1233,AH-19,1234,1,3,1946,1940,1947,4,3
1234,AH-19,1235,1,3,1959,1950,1960,4,3
1235,AH-19,1236,1,3,1979,1970,1980,4,3
1236,AH-19,1237,1,4,1997,1990,1998,4,3
1237,AH-20,1238,1,3,1920,1920,1921,6,3
1238,AH-20,1239,1,3,1924,1920,1925,6,3
1239,AH-20,1240,1,3,1926,1920,1927,6,3
1240,AH-20,1241,1,4,1928,1920,1929,6,3
1241,AH-20,1242,1,3,1978,1970,1979,6,3
1242,AH-20,1243,1,6,2003,2000,2004,6,3
1243,AH-20,1244,1,3,2013,2010,2014,6,3
1244,AH-21,1245,1,3,1916,1910,1917,4,3
1245,AH-21,1246,1,3,1919,1910,1920,4,3
1246,AH-21,1247,1,3,1925,1920,1926,4,3
1247,AH-21,1248,1,4,1928,1920,1929,4,3
1248,AH-21,1249,1,3,1966,1960,1967,4,3
1249,AH-21,1250,1,3,1969,1960,1970,4,3
1250,AH-22,1251,2,3,1925,1920,1927,4,3
1251,AH-22,1252,1,4,1991,1990,1992,4,3
1252,AH-22,1253,1,3,2003,2000,2004,4,3
1253,AH-22,1254,1,3,2012,2010,2013,4,3
1254,AH-23,1255,2,3,1925,1920,1927,7,3
1255,AH-23,1256,1,3,1930,1930,1931,7,3
1256,AH-23,1257,1,7,1968,1960,1969,7,3
1257,AH-23,1258,1,6,1970,1970,1971,7,3
1258,AH-23,1259,3,5,1972,1970,1975,7,3
1259,AH-23,1260,4,6,1976,1970,1980,7,3
1260,AH-23,1261,1,3,1981,1980,1982,7,3
1261,AH-23,1262,6,5,1984,1980,1990,7,3
1262,AH-23,1263,2,4,1991,1990,1993,7,3
1263,AH-23,1264,3,7,1994,1990,1997,7,3
1264,AH-23,1265,1,3,2003,2000,2004,7,3
1265,AH-23,1266,1,5,2007,2000,2008,7,3
1266,AH-23,1267,1,5,2015,2010,2016,7,3
1267,AH-24,1268,1,3,1919,1910,1920,10,3
1268,AH-24,1269,1,3,1959,1950,1960,10,3
1269,AH-24,1270,1,5,1962,1960,1963,10,3
1270,AH-24,1271,1,4,1964,1960,1965,10,3
1271,AH-24,1272,11,10,1966,1960,1977,10,3
1272,AH-24,1273,3,6,1978,1970,1981,10,3
1273,AH-24,1274,1,4,1984,1980,1985,10,3
1274,AH-24,1275,4,7,1989,1980,1993,10,3
1275,AH-24,1276,1,4,1994,1990,1995,10,3
1276,AH-24,1277,1,5,1997,1990,1998,10,3
1277,AH-24,1278,1,6,1999,1990,2000,10,3
1278,AH-24,1279,1,5,2004,2000,2005,10,3
1279,AH-24,1280,2,4,2008,2000,2010,10,3
1280,AH-24,1281,1,4,2011,2010,2012,10,3
1281,AH-24,1282,1,3,2013,2010,2014,10,3
1282,AH-24,1283,1,3,2016,2010,2017,10,3
1283,AH-25,1284,1,3,1928,1920,1929,9,3
1284,AH-25,1285,1,3,1947,1940,1948,9,3
1285,AH-25,1286,1,3,1961,1960,1962,9,3
1286,AH-25,1287,8,9,1964,1960,1972,9,3
1287,AH-25,1288,2,5,1973,1970,1975,9,3
1288,AH-25,1289,6,7,1976,1970,1982,9,3
1289,AH-25,1290,2,7,1983,1980,1985,9,3
1290,AH-25,1291,2,5,1988,1980,1990,9,3
1291,AH-25,1292,4,9,1991,1990,1995,9,3
1292,AH-25,1293,8,5,1996,1990,2004,9,3
1293,AH-25,1294,1,3,2005,2000,2006,9,3
1294,AH-25,1295,1,4,2008,2000,2009,9,3
1295,AH-25,1296,1,5,2011,2010,2012,9,3
1296,AH-25,1297,1,8,2016,2010,2017,9,3
1297,AH-26,1298,1,4,1915,1910,1916,11,3
1298,AH-26,1299,1,3,1930,1930,1931,11,3
1299,AH-26,1300,1,4,1962,1960,1963,11,3
1300,AH-26,1301,1,3,1965,1960,1966,11,3
1301,AH-26,1302,1,4,1967,1960,1968,11,3
1302,AH-26,1303,6,10,1970,1970,1976,11,3
1303,AH-26,1304,5,5,1977,1970,1982,11,3
1304,AH-26,1305,3,5,1984,1980,1987,11,3
1305,AH-26,1306,8,11,1990,1990,1998,11,3
1306,AH-26,1307,1,3,1999,1990,2000,11,3
1307,AH-26,1308,2,3,2001,2000,2003,11,3
1308,AH-26,1309,1,4,2004,2000,2005,11,3
1309,AH-26,1310,1,5,2007,2000,2008,11,3
1310,AH-26,1311,3,4,2014,2010,2017,11,3
1311,AH-27,1312,1,3,1970,1970,1971,11,3
1312,AH-27,1313,4,9,1972,1970,1976,11,3
1313,AH-27,1314,1,3,1978,1970,1979,11,3
1314,AH-27,1315,1,5,1986,1980,1987,11,3
1315,AH-27,1316,1,3,1989,1980,1990,11,3
1316,AH-27,1317,1,11,1991,1990,1992,11,3
1317,AH-27,1318,1,4,1993,1990,1994,11,3
1318,AH-27,1319,3,5,1996,1990,1999,11,3
1319,AH-27,1320,2,4,2000,2000,2002,11,3
1320,AH-27,1321,1,4,2008,2000,2009,11,3
1321,AH-27,1322,1,4,2014,2010,2015,11,3
1322,AH-28,1323,2,4,1973,1970,1975,5,3
1323,AH-28,1324,1,3,1982,1980,1983,5,3
1324,AH-28,1325,2,3,1996,1990,1998,5,3
1325,AH-28,1326,1,5,2006,2000,2007,5,3
1326,AH-29,1327,1,5,1975,1970,1976,5,3
1327,AH-29,1328,1,3,1980,1980,1981,5,3
1328,AH-29,1329,1,3,1995,1990,1996,5,3
1329,AH-29,1330,1,3,2009,2000,2010,5,3
1330,AH-30,1331,1,3,1974,1970,1975,3,3
1331,AH-30,1332,1,3,1986,1980,1987,3,3
1332,AH-30,1333,1,3,2003,2000,2004,3,3
1333,AH-30,1334,1,3,2015,2010,2016,3,3
1334,AH-31,1335,1,3,1978,1970,1979,6,3
1335,AH-31,1336,1,3,1981,1980,1982,6,3
1336,AH-31,1337,1,6,1997,1990,1998,6,3
1337,AH-31,1338,1,4,2006,2000,2007,6,3
1338,AH-32,1339,2,4,1975,1970,1977,4,3
1339,AH-32,1340,1,3,1994,1990,1995,4,3
1340,AH-33,1341,1,3,1973,1970,1974,3,3
1341,AH-33,1342,1,3,2008,2000,2009,3,3
1342,AH-34,1343,2,3,1982,1980,1984,5,3
1343,AH-34,1344,1,3,1990,1990,1991,5,3
1344,AH-34,1345,1,5,1995,1990,1996,5,3
1345,AH-34,1346,1,3,2003,2000,2004,5,3
1346,AH-34,1347,2,4,2005,2000,2007,5,3
1347,AH-34,1348,1,4,2011,2010,2012,5,3
1348,AH-35,1349,1,3,1993,1990,1994,4,3
1349,AH-35,1350,1,3,1995,1990,1996,4,3
1350,AH-35,1351,1,3,2004,2000,2005,4,3
1351,AH-35,1352,1,3,2013,2010,2014,4,3
1352,AH-35,1353,1,4,2016,2010,2017,4,3
1353,AH-36,1354,1,3,1976,1970,1977,3,3
1354,AH-8,1355,1,3,1988,1980,1989,3,3
1355,AH-8,1356,1,3,1992,1990,1993,3,3
1356,AH-9,1357,1,3,1974,1970,1975,8,3
1357,AH-9,1358,1,8,1981,1980,1982,8,3
1358,AH-9,1359,2,3,1984,1980,1986,8,3
1359,AH-9,1360,1,4,1988,1980,1989,8,3
1360,AI-11,1361,1,3,1915,1910,1916,3,3
1361,AI-11,1362,1,3,1918,1910,1919,3,3
1362,AI-11,1363,1,3,1922,1920,1923,3,3
1363,AI-11,1364,1,3,1925,1920,1926,3,3
1364,AI-11,1365,1,3,1969,1960,1970,3,3
1365,AI-11,1366,2,3,1974,1970,1976,3,3
1366,AI-11,1367,1,3,1978,1970,1979,3,3
1367,AI-12,1368,2,3,1918,1910,1920,9,3
1368,AI-12,1369,1,5,1922,1920,1923,9,3
1369,AI-12,1370,2,6,1928,1920,1930,9,3
1370,AI-12,1371,1,3,1944,1940,1945,9,3
1371,AI-12,1372,1,4,1946,1940,1947,9,3
1372,AI-12,1373,1,5,1948,1940,1949,9,3
1373,AI-12,1374,2,5,1952,1950,1954,9,3
1374,AI-12,1375,2,6,1955,1950,1957,9,3
1375,AI-12,1376,1,3,1959,1950,1960,9,3
1376,AI-12,1377,2,5,1961,1960,1963,9,3
1377,AI-12,1378,1,3,1965,1960,1966,9,3
1378,AI-12,1379,4,8,1968,1960,1972,9,3
1379,AI-12,1380,1,6,1973,1970,1974,9,3
1380,AI-12,1381,2,9,1975,1970,1977,9,3
1381,AI-12,1382,5,4,1978,1970,1983,9,3
1382,AI-12,1383,1,4,1988,1980,1989,9,3
1383,AI-12,1384,2,5,1991,1990,1993,9,3
1384,AI-12,1385,1,3,1996,1990,1997,9,3
1385,AI-13,1386,4,4,1896,1890,1900,10,3
1386,AI-13,1387,3,5,1901,1900,1904,10,3
1387,AI-13,1388,2,3,1907,1900,1909,10,3
1388,AI-13,1389,2,5,1910,1910,1912,10,3
1389,AI-13,1390,1,4,1914,1910,1915,10,3
1390,AI-13,1391,1,6,1916,1910,1917,10,3
1391,AI-13,1392,4,6,1919,1910,1923,10,3
1392,AI-13,1393,6,10,1925,1920,1931,10,3
1393,AI-13,1394,1,4,1941,1940,1942,10,3
1394,AI-13,1395,7,6,1943,1940,1950,10,3
1395,AI-13,1396,3,9,1955,1950,1958,10,3
1396,AI-13,1397,2,8,1959,1950,1961,10,3
1397,AI-13,1398,3,7,1962,1960,1965,10,3
1398,AI-13,1399,2,8,1966,1960,1968,10,3
1399,AI-13,1400,8,8,1969,1960,1977,10,3
1400,AI-13,1401,3,6,1978,1970,1981,10,3
1401,AI-13,1402,1,3,2003,2000,2004,10,3
1402,AI-13,1403,1,4,2005,2000,2006,10,3
1403,AI-14,1404,1,3,1877,1870,1878,7,3
1404,AI-14,1405,1,3,1883,1880,1884,7,3
1405,AI-14,1406,1,6,1894,1890,1895,7,3
1406,AI-14,1407,4,6,1896,1890,1900,7,3
1407,AI-14,1408,2,7,1901,1900,1903,7,3
1408,AI-14,1409,1,5,1920,1920,1921,7,3
1409,AI-14,1410,3,4,1927,1920,1930,7,3
1410,AI-14,1411,1,3,1942,1940,1943,7,3
1411,AI-14,1412,1,3,1946,1940,1947,7,3
1412,AI-14,1413,1,3,1952,1950,1953,7,3
1413,AI-14,1414,1,3,1960,1960,1961,7,3
1414,AI-14,1415,1,3,1964,1960,1965,7,3
1415,AI-14,1416,1,3,1968,1960,1969,7,3
1416,AI-14,1417,3,3,1971,1970,1974,7,3
1417,AI-14,1418,1,4,1979,1970,1980,7,3
1418,AI-14,1419,1,3,1987,1980,1988,7,3
1419,AI-15,1420,1,4,1880,1880,1881,9,3
1420,AI-15,1421,4,6,1883,1880,1887,9,3
1421,AI-15,1422,8,9,1888,1880,1896,9,3
1422,AI-15,1423,1,3,1897,1890,1898,9,3
1423,AI-15,1424,3,6,1901,1900,1904,9,3
1424,AI-15,1425,1,6,1912,1910,1913,9,3
1425,AI-15,1426,1,3,1919,1910,1920,9,3
1426,AI-15,1427,1,3,1923,1920,1924,9,3
1427,AI-15,1428,1,3,1927,1920,1928,9,3
1428,AI-15,1429,1,3,1929,1920,1930,9,3
1429,AI-16,1430,1,3,1980,1980,1981,3,3
1430,AI-17,1431,1,3,1895,1890,1896,7,3
1431,AI-17,1432,1,3,1898,1890,1899,7,3
1432,AI-17,1433,1,6,1903,1900,1904,7,3
1433,AI-17,1434,1,4,1909,1900,1910,7,3
1434,AI-17,1435,3,7,1911,1910,1914,7,3
1435,AI-17,1436,1,7,1919,1910,1920,7,3
1436,AI-17,1437,3,7,1922,1920,1925,7,3
1437,AI-17,1438,3,6,1927,1920,1930,7,3
1438,AI-17,1439,1,4,1942,1940,1943,7,3
1439,AI-17,1440,1,4,1955,1950,1956,7,3
1440,AI-17,1441,1,3,1959,1950,1960,7,3
1441,AI-17,1442,1,3,1973,1970,1974,7,3
1442,AI-17,1443,1,3,1980,1980,1981,7,3
1443,AI-17,1444,1,3,1988,1980,1989,7,3
1444,AI-17,1445,1,5,1991,1990,1992,7,3
1445,AI-17,1446,1,6,1996,1990,1997,7,3
1446,AI-18,1447,1,4,1908,1900,1909,11,3
1447,AI-18,1448,1,3,1911,1910,1912,11,3
1448,AI-18,1449,3,4,1913,1910,1916,11,3
1449,AI-18,1450,1,4,1917,1910,1918,11,3
1450,AI-18,1451,10,8,1919,1910,1929,11,3
1451,AI-18,1452,1,11,1930,1930,1931,11,3
1452,AI-18,1453,1,5,1941,1940,1942,11,3
1453,AI-18,1454,2,3,1947,1940,1949,11,3
1454,AI-18,1455,1,3,1950,1950,1951,11,3
1455,AI-18,1456,1,4,1952,1950,1953,11,3
1456,AI-18,1457,1,4,1956,1950,1957,11,3
1457,AI-18,1458,1,3,1964,1960,1965,11,3
1458,AI-18,1459,1,3,1991,1990,1992,11,3
1459,AI-19,1460,1,3,1902,1900,1903,6,3
1460,AI-19,1461,2,4,1924,1920,1926,6,3
1461,AI-19,1462,13,6,1928,1920,1941,6,3
1462,AI-19,1463,1,4,1945,1940,1946,6,3
1463,AI-19,1464,1,5,1947,1940,1948,6,3
1464,AI-19,1465,2,4,1953,1950,1955,6,3
1465,AI-19,1466,1,3,1957,1950,1958,6,3
1466,AI-19,1467,1,4,1970,1970,1971,6,3
1467,AI-19,1468,1,3,1973,1970,1974,6,3
1468,AI-19,1469,3,4,1978,1970,1981,6,3
1469,AI-19,1470,1,4,1983,1980,1984,6,3
1470,AI-19,1471,1,3,1987,1980,1988,6,3
1471,AI-19,1472,2,5,1989,1980,1991,6,3
1472,AI-20,1473,1,3,1919,1910,1920,7,3
1473,AI-20,1474,1,7,1925,1920,1926,7,3
1474,AI-20,1475,1,4,1928,1920,1929,7,3
1475,AI-20,1476,2,5,1965,1960,1967,7,3
1476,AI-20,1477,1,4,1977,1970,1978,7,3
1477,AI-20,1478,1,4,1979,1970,1980,7,3
1478,AI-20,1479,1,4,1981,1980,1982,7,3
1479,AI-20,1480,1,7,1989,1980,1990,7,3
1480,AI-20,1481,1,3,1996,1990,1997,7,3
1481,AI-20,1482,1,3,2000,2000,2001,7,3
1482,AI-20,1483,2,4,2015,2010,2017,7,3
1483,AI-21,1484,1,3,1921,1920,1922,6,3
1484,AI-21,1485,4,6,1927,1920,1931,6,3
1485,AI-21,1486,1,3,1944,1940,1945,6,3
1486,AI-21,1487,1,4,1948,1940,1949,6,3
1487,AI-21,1488,1,3,1951,1950,1952,6,3
1488,AI-21,1489,3,3,1954,1950,1957,6,3
1489,AI-21,1490,1,4,1962,1960,1963,6,3
1490,AI-21,1491,1,5,1966,1960,1967,6,3
1491,AI-21,1492,1,4,1968,1960,1969,6,3
1492,AI-21,1493,1,3,1970,1970,1971,6,3
1493,AI-21,1494,4,5,1973,1970,1977,6,3
1494,AI-21,1495,1,4,1980,1980,1981,6,3
1495,AI-21,1496,1,5,1991,1990,1992,6,3
1496,AI-21,1497,1,5,1994,1990,1995,6,3
1497,AI-21,1498,1,4,1998,1990,1999,6,3
1498,AI-22,1499,1,3,1963,1960,1964,5,3
1499,AI-22,1500,2,4,1966,1960,1968,5,3
1500,AI-22,1501,1,3,1970,1970,1971,5,3
1501,AI-22,1502,1,5,1981,1980,1982,5,3
1502,AI-22,1503,1,3,1988,1980,1989,5,3
1503,AI-22,1504,1,3,1992,1990,1993,5,3
1504,AI-23,1505,2,4,1949,1940,1951,8,3
1505,AI-23,1506,1,5,1955,1950,1956,8,3
1506,AI-23,1507,1,4,1957,1950,1958,8,3
1507,AI-23,1508,1,3,1965,1960,1966,8,3
1508,AI-23,1509,2,8,1967,1960,1969,8,3
1509,AI-23,1510,3,4,1971,1970,1974,8,3
1510,AI-23,1511,7,6,1975,1970,1982,8,3
1511,AI-23,1512,1,5,1985,1980,1986,8,3
1512,AI-23,1513,1,3,1988,1980,1989,8,3
1513,AI-23,1514,1,6,1990,1990,1991,8,3
1514,AI-23,1515,4,5,1992,1990,1996,8,3
1515,AI-23,1516,1,4,1997,1990,1998,8,3
1516,AI-23,1517,1,3,1999,1990,2000,8,3
1517,AI-23,1518,2,4,2001,2000,2003,8,3
1518,AI-23,1519,1,3,2006,2000,2007,8,3
1519,AI-23,1520,1,3,2009,2000,2010,8,3
1520,AI-23,1521,1,3,2013,2010,2014,8,3
1521,AI-23,1522,1,3,2016,2010,2017,8,3
1522,AI-24,1523,1,3,1907,1900,1908,13,3
1523,AI-24,1524,1,4,1924,1920,1925,13,3
1524,AI-24,1525,1,3,1941,1940,1942,13,3
1525,AI-24,1526,1,3,1950,1950,1951,13,3
1526,AI-24,1527,1,3,1954,1950,1955,13,3
1527,AI-24,1528,2,4,1958,1950,1960,13,3
1528,AI-24,1529,1,8,1962,1960,1963,13,3
1529,AI-24,1530,11,13,1964,1960,1975,13,3
1530,AI-24,1531,4,6,1976,1970,1980,13,3
1531,AI-24,1532,1,4,1982,1980,1983,13,3
1532,AI-24,1533,1,4,1992,1990,1993,13,3
1533,AI-24,1534,2,4,1994,1990,1996,13,3
1534,AI-24,1535,3,5,2001,2000,2004,13,3
1535,AI-24,1536,1,3,2009,2000,2010,13,3
1536,AI-24,1537,1,3,2011,2010,2012,13,3
1537,AI-24,1538,1,3,2016,2010,2017,13,3
1538,AI-25,1539,1,3,1961,1960,1962,9,3
1539,AI-25,1540,8,8,1964,1960,1972,9,3
1540,AI-25,1541,4,9,1973,1970,1977,9,3
1541,AI-25,1542,2,8,1979,1970,1981,9,3
1542,AI-25,1543,2,4,1983,1980,1985,9,3
1543,AI-25,1544,1,7,1987,1980,1988,9,3
1544,AI-25,1545,3,8,1989,1980,1992,9,3
1545,AI-25,1546,2,5,1993,1990,1995,9,3
1546,AI-25,1547,2,5,1998,1990,2000,9,3
1547,AI-25,1548,1,4,2002,2000,2003,9,3
1548,AI-25,1549,1,4,2011,2010,2012,9,3
1549,AI-26,1550,1,4,1969,1960,1970,7,3
1550,AI-26,1551,1,7,1971,1970,1972,7,3
1551,AI-26,1552,2,4,1973,1970,1975,7,3
1552,AI-26,1553,3,5,1978,1970,1981,7,3
1553,AI-26,1554,6,5,1982,1980,1988,7,3
1554,AI-26,1555,1,3,1989,1980,1990,7,3
1555,AI-26,1556,1,4,1991,1990,1992,7,3
1556,AI-26,1557,4,4,1996,1990,2000,7,3
1557,AI-26,1558,1,3,2006,2000,2007,7,3
1558,AI-26,1559,1,5,2009,2000,2010,7,3
1559,AI-26,1560,1,6,2011,2010,2012,7,3
1560,AI-26,1561,2,4,2015,2010,2017,7,3
1561,AI-27,1562,1,3,1964,1960,1965,5,3
1562,AI-27,1563,1,3,1971,1970,1972,5,3
1563,AI-27,1564,1,3,1980,1980,1981,5,3
1564,AI-27,1565,1,3,1986,1980,1987,5,3
1565,AI-27,1566,1,5,1991,1990,1992,5,3
1566,AI-27,1567,1,5,1995,1990,1996,5,3
1567,AI-27,1568,2,4,2001,2000,2003,5,3
1568,AI-27,1569,1,4,2004,2000,2005,5,3
1569,AI-27,1570,1,3,2013,2010,2014,5,3
1570,AI-27,1571,1,3,2015,2010,2016,5,3
1571,AI-28,1572,1,3,1997,1990,1998,4,3
1572,AI-28,1573,1,4,2011,2010,2012,4,3
1573,AI-29,1574,1,5,1946,1940,1947,5,3
1574,AI-29,1575,2,3,1992,1990,1994,5,3
1575,AI-30,1576,2,3,1983,1980,1985,4,3
1576,AI-30,1577,2,4,1993,1990,1995,4,3
1577,AI-30,1578,1,3,2006,2000,2007,4,3
1578,AI-31,1579,1,3,1976,1970,1977,4,3
1579,AI-31,1580,1,4,1983,1980,1984,4,3
1580,AI-31,1581,1,4,1986,1980,1987,4,3
1581,AI-31,1582,1,4,1990,1990,1991,4,3
1582,AI-31,1583,1,3,2008,2000,2009,4,3
1583,AI-32,1584,1,5,1984,1980,1985,5,3
1584,AI-32,1585,1,4,1987,1980,1988,5,3
1585,AI-32,1586,1,4,1991,1990,1992,5,3
1586,AI-32,1587,1,4,1994,1990,1995,5,3
1587,AI-32,1588,1,3,1997,1990,1998,5,3
1588,AI-32,1589,1,3,2010,2010,2011,5,3
1589,AI-32,1590,1,3,2015,2010,2016,5,3
1590,AI-33,1591,1,4,1976,1970,1977,5,3
1591,AI-33,1592,2,3,1985,1980,1987,5,3
1592,AI-33,1593,1,3,1997,1990,1998,5,3
1593,AI-33,1594,1,4,2003,2000,2004,5,3
1594,AI-33,1595,1,4,2009,2000,2010,5,3
1595,AI-33,1596,5,5,2012,2010,2017,5,3
1596,AI-34,1597,2,6,1977,1970,1979,6,3
1597,AI-34,1598,1,3,1980,1980,1981,6,3
1598,AI-34,1599,1,4,1982,1980,1983,6,3
1599,AI-34,1600,2,4,1989,1980,1991,6,3
1600,AI-34,1601,3,4,1992,1990,1995,6,3
1601,AI-34,1602,1,4,2005,2000,2006,6,3
1602,AI-34,1603,1,3,2010,2010,2011,6,3
1603,AI-35,1604,1,3,1979,1970,1980,5,3
1604,AI-35,1605,1,5,1983,1980,1984,5,3
1605,AJ-12,1606,1,4,1982,1980,1983,4,4
1606,AJ-13,1607,1,3,1925,1920,1926,6,3
1607,AJ-13,1608,2,3,1928,1920,1930,6,3
1608,AJ-13,1609,1,4,1947,1940,1948,6,3
1609,AJ-13,1610,1,3,1973,1970,1974,6,3
1610,AJ-13,1611,1,6,1978,1970,1979,6,3
1611,AJ-13,1612,1,3,1992,1990,1993,6,3
1612,AJ-14,1613,1,4,1953,1950,1954,4,3
1613,AJ-14,1614,1,3,1961,1960,1962,4,3
1614,AJ-14,1615,2,3,1981,1980,1983,4,3
1615,AJ-15,1616,1,3,1894,1890,1895,7,3
1616,AJ-15,1617,2,3,1901,1900,1903,7,3
1617,AJ-15,1618,1,6,1910,1910,1911,7,3
1618,AJ-15,1619,1,3,1916,1910,1917,7,3
1619,AJ-15,1620,1,4,1919,1910,1920,7,3
1620,AJ-15,1621,1,5,1924,1920,1925,7,3
1621,AJ-15,1622,2,4,1928,1920,1930,7,3
1622,AJ-15,1623,1,3,1946,1940,1947,7,3
1623,AJ-15,1624,1,5,1948,1940,1949,7,3
1624,AJ-15,1625,1,3,1953,1950,1954,7,3
1625,AJ-15,1626,1,6,1957,1950,1958,7,3
1626,AJ-15,1627,2,3,1970,1970,1972,7,3
1627,AJ-15,1628,1,3,1973,1970,1974,7,3
1628,AJ-15,1629,3,7,1978,1970,1981,7,3
1629,AJ-15,1630,1,3,1992,1990,1993,7,3
1630,AJ-16,1631,2,4,1880,1880,1882,8,3
1631,AJ-16,1632,1,3,1891,1890,1892,8,3
1632,AJ-16,1633,6,6,1895,1890,1901,8,3
1633,AJ-16,1634,2,8,1903,1900,1905,8,3
1634,AJ-16,1635,2,4,1908,1900,1910,8,3
1635,AJ-16,1636,2,4,1913,1910,1915,8,3
1636,AJ-16,1637,1,3,1916,1910,1917,8,3
1637,AJ-16,1638,1,4,1921,1920,1922,8,3
1638,AJ-16,1639,1,6,1924,1920,1925,8,3
1639,AJ-16,1640,1,4,1926,1920,1927,8,3
1640,AJ-16,1641,2,3,1928,1920,1930,8,3
1641,AJ-16,1642,4,4,1947,1940,1951,8,3
1642,AJ-16,1643,4,5,1952,1950,1956,8,3
1643,AJ-16,1644,1,3,1957,1950,1958,8,3
1644,AJ-16,1645,1,4,1968,1960,1969,8,3
1645,AJ-16,1646,1,3,1971,1970,1972,8,3
1646,AJ-16,1647,1,3,1976,1970,1977,8,3
1647,AJ-16,1648,1,3,1996,1990,1997,8,3
1648,AJ-17,1649,1,3,1882,1880,1883,8,3
1649,AJ-17,1650,3,5,1894,1890,1897,8,3
1650,AJ-17,1651,7,8,1898,1890,1905,8,3
1651,AJ-17,1652,2,7,1907,1900,1909,8,3
1652,AJ-17,1653,5,8,1910,1910,1915,8,3
1653,AJ-17,1654,1,3,1916,1910,1917,8,3
1654,AJ-17,1655,8,8,1919,1910,1927,8,3
1655,AJ-17,1656,3,6,1928,1920,1931,8,3
1656,AJ-17,1657,2,5,1942,1940,1944,8,3
1657,AJ-17,1658,1,4,1947,1940,1948,8,3
1658,AJ-17,1659,1,4,1953,1950,1954,8,3
1659,AJ-17,1660,1,3,1958,1950,1959,8,3
1660,AJ-17,1661,1,3,1962,1960,1963,8,3
1661,AJ-17,1662,1,4,1964,1960,1965,8,3
1662,AJ-17,1663,1,4,1969,1960,1970,8,3
1663,AJ-17,1664,1,3,1971,1970,1972,8,3
1664,AJ-17,1665,1,3,1974,1970,1975,8,3
1665,AJ-17,1666,1,4,1986,1980,1987,8,3
1666,AJ-17,1667,1,3,2003,2000,2004,8,3
1667,AJ-18,1668,2,5,1893,1890,1895,11,3
1668,AJ-18,1669,2,4,1901,1900,1903,11,3
1669,AJ-18,1670,2,6,1908,1900,1910,11,3
1670,AJ-18,1671,1,3,1911,1910,1912,11,3
1671,AJ-18,1672,2,4,1913,1910,1915,11,3
1672,AJ-18,1673,1,8,1918,1910,1919,11,3
1673,AJ-18,1674,2,7,1920,1920,1922,11,3
1674,AJ-18,1675,3,9,1923,1920,1926,11,3
1675,AJ-18,1676,4,11,1927,1920,1931,11,3
1676,AJ-18,1677,1,4,1943,1940,1944,11,3
1677,AJ-18,1678,4,7,1947,1940,1951,11,3
1678,AJ-18,1679,3,11,1952,1950,1955,11,3
1679,AJ-18,1680,1,4,1956,1950,1957,11,3
1680,AJ-18,1681,3,6,1958,1950,1961,11,3
1681,AJ-18,1682,1,3,1964,1960,1965,11,3
1682,AJ-18,1683,1,4,1970,1970,1971,11,3
1683,AJ-18,1684,3,4,1972,1970,1975,11,3
1684,AJ-18,1685,2,6,1976,1970,1978,11,3
1685,AJ-18,1686,6,6,1979,1970,1985,11,3
1686,AJ-18,1687,1,6,1986,1980,1987,11,3
1687,AJ-18,1688,4,7,1988,1980,1992,11,3
1688,AJ-18,1689,1,3,1993,1990,1994,11,3
1689,AJ-18,1690,3,10,1997,1990,2000,11,3
1690,AJ-18,1691,7,6,2001,2000,2008,11,3
1691,AJ-19,1692,2,4,1902,1900,1904,25,3
1692,AJ-19,1693,1,6,1909,1900,1910,25,3
1693,AJ-19,1694,45,25,1911,1910,1956,25,3
1694,AJ-19,1695,2,7,1957,1950,1959,25,3
1695,AJ-19,1696,3,7,1961,1960,1964,25,3
1696,AJ-19,1697,1,3,1965,1960,1966,25,3
1697,AJ-19,1698,1,3,1967,1960,1968,25,3
1698,AJ-19,1699,1,3,1971,1970,1972,25,3
1699,AJ-19,1700,4,4,1978,1970,1982,25,3
1700,AJ-19,1701,2,5,1989,1980,1991,25,3
1701,AJ-19,1702,2,4,1992,1990,1994,25,3
1702,AJ-20,1703,1,3,1911,1910,1912,19,3
1703,AJ-20,1704,15,19,1916,1910,1931,19,3
1704,AJ-20,1705,52,17,1941,1940,1993,19,3
1705,AJ-20,1706,1,5,1994,1990,1995,19,3
1706,AJ-20,1707,4,9,1996,1990,2000,19,3
1707,AJ-20,1708,1,8,2001,2000,2002,19,3
1708,AJ-20,1709,1,3,2008,2000,2009,19,3
1709,AJ-20,1710,1,3,2014,2010,2015,19,3
1710,AJ-21,1711,1,3,1903,1900,1904,24,3
1711,AJ-21,1712,13,15,1918,1910,1931,24,3
1712,AJ-21,1713,18,11,1941,1940,1959,24,3
1713,AJ-21,1714,1,3,1960,1960,1961,24,3
1714,AJ-21,1715,32,24,1963,1960,1995,24,3
1715,AJ-21,1716,6,12,1996,1990,2002,24,3
1716,AJ-21,1717,1,5,2011,2010,2012,24,3
1717,AJ-22,1718,1,3,1908,1900,1909,16,3
1718,AJ-22,1719,2,3,1912,1910,1914,16,3
1719,AJ-22,1720,3,3,1915,1910,1918,16,3
1720,AJ-22,1721,3,4,1919,1910,1922,16,3
1721,AJ-22,1722,7,15,1924,1920,1931,16,3
1722,AJ-22,1723,16,11,1941,1940,1957,16,3
1723,AJ-22,1724,4,10,1958,1950,1962,16,3
1724,AJ-22,1725,3,5,1963,1960,1966,16,3
1725,AJ-22,1726,29,16,1967,1960,1996,16,3
1726,AJ-22,1727,2,10,1997,1990,1999,16,3
1727,AJ-22,1728,4,7,2000,2000,2004,16,3
1728,AJ-22,1729,2,4,2007,2000,2009,16,3
1729,AJ-22,1730,1,3,2010,2010,2011,16,3
1730,AJ-23,1731,3,4,1920,1920,1923,16,4
1731,AJ-23,1732,1,4,1925,1920,1926,16,4
1732,AJ-23,1733,1,5,1928,1920,1929,16,4
1733,AJ-23,1734,3,10,1941,1940,1944,16,4
1734,AJ-23,1735,4,12,1945,1940,1949,16,4
1735,AJ-23,1736,7,6,1950,1950,1957,16,4
1736,AJ-23,1737,4,7,1958,1950,1962,16,4
1737,AJ-23,1738,31,16,1964,1960,1995,16,4
1738,AJ-23,1739,4,8,1997,1990,2001,16,4
1739,AJ-23,1740,2,4,2005,2000,2007,16,4
1740,AJ-23,1741,1,4,2010,2010,2011,16,4
1741,AJ-23,1742,1,8,2012,2010,2013,16,4
1742,AJ-23,1743,1,5,2016,2010,2017,16,4
1743,AJ-24,1744,2,4,1941,1940,1943,8,3
1744,AJ-24,1745,1,5,1944,1940,1945,8,3
1745,AJ-24,1746,1,5,1946,1940,1947,8,3
1746,AJ-24,1747,1,5,1948,1940,1949,8,3
1747,AJ-24,1748,1,5,1953,1950,1954,8,3
1748,AJ-24,1749,1,4,1958,1950,1959,8,3
1749,AJ-24,1750,10,8,1966,1960,1976,8,3
1750,AJ-24,1751,3,5,1977,1970,1980,8,3
1751,AJ-24,1752,2,6,1981,1980,1983,8,3
1752,AJ-24,1753,1,4,1984,1980,1985,8,3
1753,AJ-24,1754,2,6,1986,1980,1988,8,3
1754,AJ-24,1755,4,8,1989,1980,1993,8,3
1755,AJ-24,1756,4,5,1994,1990,1998,8,3
1756,AJ-24,1757,1,3,2000,2000,2001,8,3
1757,AJ-24,1758,1,3,2002,2000,2003,8,3
1758,AJ-24,1759,1,6,2005,2000,2006,8,3
1759,AJ-24,1760,1,3,2008,2000,2009,8,3
1760,AJ-24,1761,1,4,2011,2010,2012,8,3
1761,AJ-24,1762,1,3,2014,2010,2015,8,3
1762,AJ-25,1763,1,4,1958,1950,1959,6,4
1763,AJ-25,1764,1,6,1981,1980,1982,6,4
1764,AJ-25,1765,1,5,1993,1990,1994,6,4
1765,AJ-25,1766,1,5,2008,2000,2009,6,4
1766,AJ-25,1767,1,4,2016,2010,2017,6,4
1767,AJ-26,1768,1,3,1966,1960,1967,5,3
1768,AJ-26,1769,1,3,1972,1970,1973,5,3
1769,AJ-26,1770,2,3,1976,1970,1978,5,3
1770,AJ-26,1771,3,5,1982,1980,1985,5,3
1771,AJ-26,1772,2,4,1990,1990,1992,5,3
1772,AJ-26,1773,1,3,1994,1990,1995,5,3
1773,AJ-26,1774,1,4,1996,1990,1997,5,3
1774,AJ-26,1775,1,3,1999,1990,2000,5,3
1775,AJ-26,1776,1,3,2001,2000,2002,5,3
1776,AJ-26,1777,3,4,2006,2000,2009,5,3
1777,AJ-26,1778,2,4,2013,2010,2015,5,3
1778,AJ-27,1779,2,5,2002,2000,2004,5,3
1779,AJ-27,1780,1,3,2008,2000,2009,5,3
1780,AJ-27,1781,1,4,2016,2010,2017,5,3
1781,AJ-29,1782,1,3,2015,2010,2016,3,3
1782,AJ-30,1783,2,4,1970,1970,1972,4,3
1783,AJ-30,1784,1,3,1975,1970,1976,4,3
1784,AJ-30,1785,1,4,1982,1980,1983,4,3
1785,AJ-30,1786,1,3,1990,1990,1991,4,3
1786,AJ-30,1787,1,4,1994,1990,1995,4,3
1787,AJ-30,1788,1,3,1996,1990,1997,4,3
1788,AJ-30,1789,1,4,2016,2010,2017,4,3
1789,AJ-31,1790,1,4,1971,1970,1972,7,4
1790,AJ-31,1791,3,5,1976,1970,1979,7,4
1791,AJ-31,1792,2,5,1980,1980,1982,7,4
1792,AJ-31,1793,1,5,1985,1980,1986,7,4
1793,AJ-31,1794,1,6,1990,1990,1991,7,4
1794,AJ-31,1795,8,5,1992,1990,2000,7,4
1795,AJ-31,1796,1,7,2001,2000,2002,7,4
1796,AJ-31,1797,1,5,2003,2000,2004,7,4
1797,AJ-31,1798,2,5,2006,2000,2008,7,4
1798,AJ-32,1799,1,3,1971,1970,1972,9,3
1799,AJ-32,1800,1,3,1973,1970,1974,9,3
1800,AJ-32,1801,1,4,1977,1970,1978,9,3
1801,AJ-32,1802,1,3,1980,1980,1981,9,3
1802,AJ-32,1803,1,4,1984,1980,1985,9,3
1803,AJ-32,1804,1,3,1988,1980,1989,9,3
1804,AJ-32,1805,2,5,1991,1990,1993,9,3
1805,AJ-32,1806,3,9,1994,1990,1997,9,3
1806,AJ-32,1807,4,4,2000,2000,2004,9,3
1807,AJ-32,1808,1,3,2006,2000,2007,9,3
1808,AJ-32,1809,1,4,2011,2010,2012,9,3
1809,AJ-32,1810,4,8,2013,2010,2017,9,3
1810,AJ-33,1811,1,3,1975,1970,1976,7,3
1811,AJ-33,1812,1,3,1978,1970,1979,7,3
1812,AJ-33,1813,1,5,1980,1980,1981,7,3
1813,AJ-33,1814,2,4,1984,1980,1986,7,3
1814,AJ-33,1815,1,4,1987,1980,1988,7,3
1815,AJ-33,1816,1,4,1989,1980,1990,7,3
1816,AJ-33,1817,2,5,1991,1990,1993,7,3
1817,AJ-33,1818,4,7,1994,1990,1998,7,3
1818,AJ-33,1819,2,4,2000,2000,2002,7,3
1819,AJ-33,1820,1,4,2004,2000,2005,7,3
1820,AJ-33,1821,1,3,2007,2000,2008,7,3
1821,AJ-33,1822,1,5,2010,2010,2011,7,3
1822,AJ-33,1823,1,5,2016,2010,2017,7,3
1823,AJ-34,1824,1,3,1978,1970,1979,7,3
1824,AJ-34,1825,2,6,1984,1980,1986,7,3
1825,AJ-34,1826,1,3,1987,1980,1988,7,3
1826,AJ-34,1827,4,4,1990,1990,1994,7,3
1827,AJ-34,1828,2,7,1995,1990,1997,7,3
1828,AJ-34,1829,1,3,1998,1990,1999,7,3
1829,AJ-34,1830,3,7,2000,2000,2003,7,3
1830,AJ-34,1831,3,5,2006,2000,2009,7,3
1831,AJ-34,1832,1,7,2015,2010,2016,7,3
1832,AJ-35,1833,1,3,1983,1980,1984,4,3
1833,AJ-35,1834,1,4,1993,1990,1994,4,3
1834,AJ-35,1835,1,3,2005,2000,2006,4,3
1835,AK-17,1836,1,3,1958,1950,1959,3,3
1836,AK-18,1837,1,3,1917,1910,1918,10,3
1837,AK-18,1838,8,8,1922,1920,1930,10,3
1838,AK-18,1839,2,6,1941,1940,1943,10,3
1839,AK-18,1840,5,9,1944,1940,1949,10,3
1840,AK-18,1841,4,10,1950,1950,1954,10,3
1841,AK-18,1842,1,3,1956,1950,1957,10,3
1842,AK-19,1843,11,12,1920,1920,1931,14,3
1843,AK-19,1844,8,14,1941,1940,1949,14,3
1844,AK-19,1845,6,11,1950,1950,1956,14,3
1845,AK-19,1846,1,4,1958,1950,1959,14,3
1846,AK-19,1847,3,5,1960,1960,1963,14,3
1847,AK-19,1848,2,4,1967,1960,1969,14,3
1848,AK-19,1849,10,6,1970,1970,1980,14,3
1849,AK-19,1850,6,6,1981,1980,1987,14,3
1850,AK-19,1851,2,4,1990,1990,1992,14,3
1851,AK-19,1852,1,3,1993,1990,1994,14,3
1852,AK-19,1853,1,3,1995,1990,1996,14,3
1853,AK-19,1854,1,3,1998,1990,1999,14,3
1854,AK-19,1855,1,3,2000,2000,2001,14,3
1855,AK-19,1856,1,3,2004,2000,2005,14,3
1856,AK-20,1857,1,8,1919,1910,1920,16,3
1857,AK-20,1858,1,3,1922,1920,1923,16,3
1858,AK-20,1859,7,9,1924,1920,1931,16,3
1859,AK-20,1860,60,16,1941,1940,2001,16,3
1860,AK-20,1861,1,3,2010,2010,2011,16,3
1861,AK-21,1862,8,23,1923,1920,1931,23,3
1862,AK-21,1863,54,18,1941,1940,1995,23,3
1863,AK-21,1864,1,3,1996,1990,1997,23,3
1864,AK-21,1865,5,5,1999,1990,2004,23,3
1865,AK-21,1866,1,3,2007,2000,2008,23,3
1866,AK-21,1867,1,3,2009,2000,2010,23,3
1867,AK-21,1868,1,3,2016,2010,2017,23,3
1868,AK-22,1869,17,11,1928,1920,1945,14,3
1869,AK-22,1870,33,14,1946,1940,1979,14,3
1870,AK-22,1871,7,7,1980,1980,1987,14,3
1871,AK-22,1872,1,4,1988,1980,1989,14,3
1872,AK-22,1873,2,5,1990,1990,1992,14,3
1873,AK-22,1874,1,3,1994,1990,1995,14,3
1874,AK-22,1875,1,5,1997,1990,1998,14,3
1875,AK-22,1876,1,4,2003,2000,2004,14,3
1876,AK-22,1877,1,4,2012,2010,2013,14,3
1877,AK-22,1878,1,4,2016,2010,2017,14,3
1878,AK-23,1879,1,3,1925,1920,1926,11,3
1879,AK-23,1880,3,8,1928,1920,1931,11,3
1880,AK-23,1881,7,9,1941,1940,1948,11,3
1881,AK-23,1882,1,3,1949,1940,1950,11,3
1882,AK-23,1883,1,4,1951,1950,1952,11,3
1883,AK-23,1884,1,7,1953,1950,1954,11,3
1884,AK-23,1885,2,5,1955,1950,1957,11,3
1885,AK-23,1886,1,5,1958,1950,1959,11,3
1886,AK-23,1887,1,5,1961,1960,1962,11,3
1887,AK-23,1888,22,11,1963,1960,1985,11,3
1888,AK-23,1889,1,3,1986,1980,1987,11,3
1889,AK-23,1890,7,9,1988,1980,1995,11,3
1890,AK-23,1891,2,5,1996,1990,1998,11,3
1891,AK-23,1892,1,5,2004,2000,2005,11,3
1892,AK-23,1893,1,3,2010,2010,2011,11,3
1893,AK-24,1894,1,3,1924,1920,1925,11,3
1894,AK-24,1895,1,3,1927,1920,1928,11,3
1895,AK-24,1896,1,3,1929,1920,1930,11,3
1896,AK-24,1897,4,4,1942,1940,1946,11,3
1897,AK-24,1898,1,4,1949,1940,1950,11,3
1898,AK-24,1899,1,7,1951,1950,1952,11,3
1899,AK-24,1900,2,4,1953,1950,1955,11,3
1900,AK-24,1901,4,4,1958,1950,1962,11,3
1901,AK-24,1902,2,3,1964,1960,1966,11,3
1902,AK-24,1903,2,5,1967,1960,1969,11,3
1903,AK-24,1904,3,8,1970,1970,1973,11,3
1904,AK-24,1905,28,11,1974,1970,2002,11,3
1905,AK-24,1906,1,3,2004,2000,2005,11,3
1906,AK-24,1907,1,6,2008,2000,2009,11,3
1907,AK-24,1908,3,8,2010,2010,2013,11,3
1908,AK-24,1909,1,8,2016,2010,2017,11,3
1909,AK-25,1910,1,3,1945,1940,1946,7,3
1910,AK-25,1911,1,4,1955,1950,1956,7,3
1911,AK-25,1912,1,3,1967,1960,1968,7,3
1912,AK-25,1913,1,3,1975,1970,1976,7,3
1913,AK-25,1914,1,3,1979,1970,1980,7,3
1914,AK-25,1915,2,3,1981,1980,1983,7,3
1915,AK-25,1916,2,4,1991,1990,1993,7,3
1916,AK-25,1917,6,7,1994,1990,2000,7,3
1917,AK-25,1918,3,4,2002,2000,2005,7,3
1918,AK-25,1919,2,5,2006,2000,2008,7,3
1919,AK-25,1920,2,3,2009,2000,2011,7,3
1920,AK-25,1921,2,6,2012,2010,2014,7,3
1921,AK-25,1922,2,5,2015,2010,2017,7,3
1922,AK-26,1923,1,3,1968,1960,1969,4,3
1923,AK-26,1924,1,3,1994,1990,1995,4,3
1924,AK-26,1925,1,4,2004,2000,2005,4,3
1925,AK-26,1926,1,3,2011,2010,2012,4,3
1926,AK-26,1927,1,3,2015,2010,2016,4,3
1927,AK-27,1928,1,3,1968,1960,1969,4,3
1928,AK-27,1929,1,3,1976,1970,1977,4,3
1929,AK-27,1930,1,3,1986,1980,1987,4,3
1930,AK-27,1931,1,3,1993,1990,1994,4,3
1931,AK-27,1932,1,4,1997,1990,1998,4,3
1932,AK-27,1933,1,4,2005,2000,2006,4,3
1933,AK-27,1934,1,3,2009,2000,2010,4,3
1934,AK-28,1935,1,3,1983,1980,1984,3,3
1935,AK-28,1936,1,3,2008,2000,2009,3,3
1936,AK-31,1937,1,3,1983,1980,1984,3,3
1937,AK-31,1938,1,3,1997,1990,1998,3,3
1938,AK-32,1939,3,7,1974,1970,1977,7,3
1939,AK-32,1940,1,3,1985,1980,1986,7,3
1940,AK-32,1941,1,4,1990,1990,1991,7,3
1941,AK-32,1942,2,3,1994,1990,1996,7,3
1942,AK-32,1943,1,3,2001,2000,2002,7,3
1943,AK-32,1944,1,3,2007,2000,2008,7,3
1944,AK-33,1945,1,5,1925,1920,1926,7,3
1945,AK-33,1946,2,4,1977,1970,1979,7,3
1946,AK-33,1947,1,3,1982,1980,1983,7,3
1947,AK-33,1948,1,3,1986,1980,1987,7,3
1948,AK-33,1949,5,7,1988,1980,1993,7,3
1949,AK-33,1950,7,4,1994,1990,2001,7,3
1950,AK-33,1951,1,3,2002,2000,2003,7,3
1951,AK-33,1952,1,3,2006,2000,2007,7,3
1952,AK-33,1953,1,3,2010,2010,2011,7,3
1953,AK-33,1954,1,3,2016,2010,2017,7,3
1954,AK-34,1955,1,3,1978,1970,1979,4,3
1955,AK-34,1956,3,4,1990,1990,1993,4,3
1956,AK-34,1957,1,3,1994,1990,1995,4,3
1957,AK-34,1958,1,4,1996,1990,1997,4,3
1958,AK-34,1959,1,3,2005,2000,2006,4,3
1959,AK-34,1960,1,3,2007,2000,2008,4,3
1960,AK-34,1961,1,3,2015,2010,2016,4,3
1961,AK-36,1962,1,4,1972,1970,1973,5,3
1962,AK-36,1963,1,5,1992,1990,1993,5,3
1963,AK-36,1964,1,3,1999,1990,2000,5,3
1964,AK-36,1965,1,3,2016,2010,2017,5,3
1965,AL-20,1966,1,3,1908,1900,1909,10,3
1966,AL-20,1967,4,6,1922,1920,1926,10,3
1967,AL-20,1968,3,8,1928,1920,1931,10,3
1968,AL-20,1969,1,3,1941,1940,1942,10,3
1969,AL-20,1970,2,5,1943,1940,1945,10,3
1970,AL-20,1971,16,10,1946,1940,1962,10,3
1971,AL-20,1972,1,7,1963,1960,1964,10,3
1972,AL-20,1973,1,6,1965,1960,1966,10,3
1973,AL-20,1974,26,8,1968,1960,1994,10,3
1974,AL-20,1975,1,6,1996,1990,1997,10,3
1975,AL-20,1976,2,5,1998,1990,2000,10,3
1976,AL-20,1977,1,3,2002,2000,2003,10,3
1977,AL-21,1978,2,4,1922,1920,1924,16,3
1978,AL-21,1979,6,6,1925,1920,1931,16,3
1979,AL-21,1980,14,9,1941,1940,1955,16,3
1980,AL-21,1981,7,10,1956,1950,1963,16,3
1981,AL-21,1982,33,16,1964,1960,1997,16,3
1982,AL-21,1983,1,5,1998,1990,1999,16,3
1983,AL-21,1984,1,3,2002,2000,2003,16,3
1984,AL-21,1985,1,3,2004,2000,2005,16,3
1985,AL-21,1986,1,3,2009,2000,2010,16,3
1986,AL-22,1987,1,3,1921,1920,1922,9,3
1987,AL-22,1988,1,3,1925,1920,1926,9,3
1988,AL-22,1989,1,6,1927,1920,1928,9,3
1989,AL-22,1990,2,9,1929,1920,1931,9,3
1990,AL-22,1991,2,4,1941,1940,1943,9,3
1991,AL-22,1992,1,4,1945,1940,1946,9,3
1992,AL-22,1993,1,4,1947,1940,1948,9,3
1993,AL-22,1994,1,4,1950,1950,1951,9,3
1994,AL-22,1995,2,9,1952,1950,1954,9,3
1995,AL-22,1996,3,5,1955,1950,1958,9,3
1996,AL-22,1997,4,8,1961,1960,1965,9,3
1997,AL-22,1998,16,9,1966,1960,1982,9,3
1998,AL-22,1999,3,7,1983,1980,1986,9,3
1999,AL-22,2000,1,3,1987,1980,1988,9,3
2000,AL-22,2001,3,6,1990,1990,1993,9,3
2001,AL-22,2002,3,5,1994,1990,1997,9,3
2002,AL-22,2003,1,6,1999,1990,2000,9,3
2003,AL-22,2004,1,4,2001,2000,2002,9,3
2004,AL-23,2005,1,3,1955,1950,1956,3,3
2005,AL-23,2006,2,3,1971,1970,1973,3,3
2006,AL-23,2007,1,3,1977,1970,1978,3,3
2007,AL-23,2008,1,3,1987,1980,1988,3,3
2008,AL-23,2009,1,3,2005,2000,2006,3,3
2009,AL-24,2010,2,5,1929,1920,1931,8,3
2010,AL-24,2011,1,4,1950,1950,1951,8,3
2011,AL-24,2012,1,3,1953,1950,1954,8,3
2012,AL-24,2013,1,3,1957,1950,1958,8,3
2013,AL-24,2014,2,4,1963,1960,1965,8,3
2014,AL-24,2015,1,5,1966,1960,1967,8,3
2015,AL-24,2016,1,3,1968,1960,1969,8,3
2016,AL-24,2017,1,5,1970,1970,1971,8,3
2017,AL-24,2018,3,5,1972,1970,1975,8,3
2018,AL-24,2019,1,4,1976,1970,1977,8,3
2019,AL-24,2020,1,4,1979,1970,1980,8,3
2020,AL-24,2021,1,8,1982,1980,1983,8,3
2021,AL-24,2022,2,5,1985,1980,1987,8,3
2022,AL-24,2023,2,8,1991,1990,1993,8,3
2023,AL-24,2024,2,5,1995,1990,1997,8,3
2024,AL-24,2025,1,3,1998,1990,1999,8,3
2025,AL-24,2026,1,3,2002,2000,2003,8,3
2026,AL-24,2027,1,3,2006,2000,2007,8,3
2027,AL-24,2028,2,3,2011,2010,2013,8,3
2028,AL-25,2029,1,3,1928,1920,1929,9,3
2029,AL-25,2030,1,3,1950,1950,1951,9,3
2030,AL-25,2031,1,8,1953,1950,1954,9,3
2031,AL-25,2032,1,3,1962,1960,1963,9,3
2032,AL-25,2033,7,9,1967,1960,1974,9,3
2033,AL-25,2034,3,6,1975,1970,1978,9,3
2034,AL-25,2035,3,5,1980,1980,1983,9,3
2035,AL-25,2036,1,3,1989,1980,1990,9,3
2036,AL-25,2037,3,6,1991,1990,1994,9,3
2037,AL-25,2038,8,4,1995,1990,2003,9,3
2038,AL-25,2039,1,3,2009,2000,2010,9,3
2039,AL-25,2040,2,4,2012,2010,2014,9,3
2040,AL-26,2041,1,4,1967,1960,1968,6,3
2041,AL-26,2042,1,3,1972,1970,1973,6,3
2042,AL-26,2043,1,5,1974,1970,1975,6,3
2043,AL-26,2044,1,4,1986,1980,1987,6,3
2044,AL-26,2045,3,6,1992,1990,1995,6,3
2045,AL-26,2046,1,3,1997,1990,1998,6,3
2046,AL-26,2047,1,4,2005,2000,2006,6,3
2047,AL-27,2048,2,7,1966,1960,1968,8,3
2048,AL-27,2049,6,5,1969,1960,1975,8,3
2049,AL-27,2050,2,5,1976,1970,1978,8,3
2050,AL-27,2051,1,3,1980,1980,1981,8,3
2051,AL-27,2052,3,4,1982,1980,1985,8,3
2052,AL-27,2053,1,3,1986,1980,1987,8,3
2053,AL-27,2054,2,6,1991,1990,1993,8,3
2054,AL-27,2055,3,5,1996,1990,1999,8,3
2055,AL-27,2056,8,8,2001,2000,2009,8,3
2056,AL-27,2057,3,6,2010,2010,2013,8,3
2057,AL-27,2058,3,7,2014,2010,2017,8,3
2058,AL-28,2059,1,3,1970,1970,1971,8,3
2059,AL-28,2060,1,3,1990,1990,1991,8,3
2060,AL-28,2061,1,5,1992,1990,1993,8,3
2061,AL-28,2062,1,3,1996,1990,1997,8,3
2062,AL-28,2063,1,3,2002,2000,2003,8,3
2063,AL-28,2064,1,4,2006,2000,2007,8,3
2064,AL-28,2065,1,4,2009,2000,2010,8,3
2065,AL-28,2066,1,5,2011,2010,2012,8,3
2066,AL-28,2067,4,8,2013,2010,2017,8,3
2067,AL-29,2068,1,3,1973,1970,1974,5,3
2068,AL-29,2069,1,3,1976,1970,1977,5,3
2069,AL-29,2070,3,4,1992,1990,1995,5,3
2070,AL-29,2071,2,3,1998,1990,2000,5,3
2071,AL-29,2072,1,5,2001,2000,2002,5,3
2072,AL-29,2073,1,3,2007,2000,2008,5,3
2073,AL-29,2074,1,5,2012,2010,2013,5,3
2074,AL-29,2075,1,3,2016,2010,2017,5,3
2075,AL-30,2076,1,3,1968,1960,1969,5,3
2076,AL-30,2077,1,3,1971,1970,1972,5,3
2077,AL-30,2078,2,3,1993,1990,1995,5,3
2078,AL-30,2079,1,3,2000,2000,2001,5,3
2079,AL-30,2080,1,5,2002,2000,2003,5,3
2080,AL-30,2081,1,4,2012,2010,2013,5,3
2081,AL-31,2082,1,3,1992,1990,1993,3,3
2082,AL-31,2083,1,3,1996,1990,1997,3,3
2083,AL-32,2084,1,3,1980,1980,1981,4,3
2084,AL-32,2085,1,4,1983,1980,1984,4,3
2085,AL-32,2086,3,3,1991,1990,1994,4,3
2086,AL-32,2087,1,3,2002,2000,2003,4,3
2087,AL-32,2088,1,3,2012,2010,2013,4,3
2088,AL-33,2089,1,3,1969,1960,1970,3,3
2089,AL-36,2090,2,5,1991,1990,1993,5,3
2090,AL-36,2091,1,3,2000,2000,2001,5,3
2091,AL-36,2092,1,3,2011,2010,2012,5,3
2092,AL-37,2093,1,5,1990,1990,1991,5,3
2093,AL-37,2094,1,3,1992,1990,1993,5,3
2094,AL-37,2095,1,3,1995,1990,1996,5,3
2095,AM-20,2096,1,3,1948,1940,1949,8,3
2096,AM-20,2097,1,3,1954,1950,1955,8,3
2097,AM-20,2098,2,4,1957,1950,1959,8,3
2098,AM-20,2099,1,3,1961,1960,1962,8,3
2099,AM-20,2100,7,8,1965,1960,1972,8,3
2100,AM-20,2101,3,6,1974,1970,1977,8,3
2101,AM-20,2102,4,6,1978,1970,1982,8,3
2102,AM-20,2103,2,3,1985,1980,1987,8,3
2103,AM-20,2104,1,3,1993,1990,1994,8,3
2104,AM-21,2105,3,5,1955,1950,1958,9,3
2105,AM-21,2106,5,7,1959,1950,1964,9,3
2106,AM-21,2107,13,9,1965,1960,1978,9,3
2107,AM-21,2108,8,7,1979,1970,1987,9,3
2108,AM-21,2109,2,5,1988,1980,1990,9,3
2109,AM-21,2110,1,6,1991,1990,1992,9,3
2110,AM-21,2111,1,3,1996,1990,1997,9,3
2111,AM-21,2112,1,3,2004,2000,2005,9,3
2112,AM-22,2113,1,3,1957,1950,1958,5,3
2113,AM-22,2114,1,5,1960,1960,1961,5,3
2114,AM-22,2115,2,3,1974,1970,1976,5,3
2115,AM-22,2116,1,3,1977,1970,1978,5,3
2116,AM-22,2117,1,3,1981,1980,1982,5,3
2117,AM-22,2118,1,3,1983,1980,1984,5,3
2118,AM-22,2119,1,4,1989,1980,1990,5,3
2119,AM-23,2120,1,3,1929,1920,1930,3,3
2120,AM-24,2121,1,4,1930,1930,1931,20,3
2121,AM-24,2122,1,3,1949,1940,1950,20,3
2122,AM-24,2123,2,8,1952,1950,1954,20,3
2123,AM-24,2124,29,20,1955,1950,1984,20,3
2124,AM-24,2125,1,4,1987,1980,1988,20,3
2125,AM-24,2126,4,5,1989,1980,1993,20,3
2126,AM-24,2127,2,5,1994,1990,1996,20,3
2127,AM-24,2128,1,4,1999,1990,2000,20,3
2128,AM-24,2129,1,4,2001,2000,2002,20,3
2129,AM-24,2130,1,4,2009,2000,2010,20,3
2130,AM-24,2131,1,3,2012,2010,2013,20,3
2131,AM-25,2132,1,3,1960,1960,1961,5,3
2132,AM-25,2133,1,5,1964,1960,1965,5,3
2133,AM-25,2134,2,4,1983,1980,1985,5,3
2134,AM-25,2135,1,3,1988,1980,1989,5,3
2135,AM-26,2136,1,3,1927,1920,1928,5,3
2136,AM-26,2137,1,5,1971,1970,1972,5,3
2137,AM-26,2138,2,5,1973,1970,1975,5,3
2138,AM-26,2139,1,3,1976,1970,1977,5,3
2139,AM-26,2140,1,4,1981,1980,1982,5,3
2140,AM-26,2141,1,5,1987,1980,1988,5,3
2141,AM-26,2142,2,5,1994,1990,1996,5,3
2142,AM-26,2143,1,3,1997,1990,1998,5,3
2143,AM-26,2144,1,3,1999,1990,2000,5,3
2144,AM-26,2145,1,3,2001,2000,2002,5,3
2145,AM-26,2146,2,4,2006,2000,2008,5,3
2146,AM-26,2147,2,3,2015,2010,2017,5,3
2147,AM-27,2148,1,3,1966,1960,1967,12,3
2148,AM-27,2149,4,12,1974,1970,1978,12,3
2149,AM-27,2150,1,5,1979,1970,1980,12,3
2150,AM-27,2151,1,3,1981,1980,1982,12,3
2151,AM-27,2152,1,7,1987,1980,1988,12,3
2152,AM-27,2153,1,3,1989,1980,1990,12,3
2153,AM-27,2154,11,7,1992,1990,2003,12,3
2154,AM-27,2155,1,3,2005,2000,2006,12,3
2155,AM-27,2156,1,4,2007,2000,2008,12,3
2156,AM-27,2157,1,4,2010,2010,2011,12,3
2157,AM-27,2158,2,6,2012,2010,2014,12,3
2158,AM-27,2159,1,4,2016,2010,2017,12,3
2159,AM-29,2160,1,3,1974,1970,1975,5,3
2160,AM-29,2161,1,3,1978,1970,1979,5,3
2161,AM-29,2162,1,3,1996,1990,1997,5,3
2162,AM-29,2163,1,4,2003,2000,2004,5,3
2163,AM-29,2164,1,5,2009,2000,2010,5,3
2164,AM-29,2165,1,3,2014,2010,2015,5,3
2165,AM-36,2166,3,6,1969,1960,1972,8,3
2166,AM-36,2167,1,3,1973,1970,1974,8,3
2167,AM-36,2168,4,6,1975,1970,1979,8,3
2168,AM-36,2169,2,4,1980,1980,1982,8,3
2169,AM-36,2170,1,8,1983,1980,1984,8,3
2170,AM-36,2171,2,4,1986,1980,1988,8,3
2171,AM-36,2172,1,3,1990,1990,1991,8,3
2172,AM-36,2173,7,5,1992,1990,1999,8,3
2173,AM-36,2174,1,3,2000,2000,2001,8,3
2174,AM-36,2175,1,5,2006,2000,2007,8,3
2175,AN-22,2176,1,8,1944,1940,1945,8,3
2176,AN-22,2177,1,3,1972,1970,1973,8,3
2177,AN-22,2178,2,3,1977,1970,1979,8,3
2178,AN-22,2179,1,4,1991,1990,1992,8,3
2179,AN-23,2180,1,4,1930,1930,1931,4,3
2180,AN-23,2181,1,3,1959,1950,1960,4,3
2181,AN-23,2182,1,3,1968,1960,1969,4,3
2182,AN-23,2183,2,3,1972,1970,1974,4,3
2183,AN-23,2184,1,3,1979,1970,1980,4,3
2184,AN-23,2185,1,4,1981,1980,1982,4,3
2185,AN-24,2186,1,4,1955,1950,1956,10,3
2186,AN-24,2187,1,3,1957,1950,1958,10,3
2187,AN-24,2188,2,5,1961,1960,1963,10,3
2188,AN-24,2189,7,10,1964,1960,1971,10,3
2189,AN-24,2190,1,4,1972,1970,1973,10,3
2190,AN-24,2191,1,3,1974,1970,1975,10,3
2191,AN-24,2192,1,5,1977,1970,1978,10,3
2192,AN-25,2193,2,3,1956,1950,1958,14,3
2193,AN-25,2194,2,4,1959,1950,1961,14,3
2194,AN-25,2195,1,6,1964,1960,1965,14,3
2195,AN-25,2196,16,14,1966,1960,1982,14,3
2196,AN-25,2197,1,6,1983,1980,1984,14,3
2197,AN-25,2198,3,4,1985,1980,1988,14,3
2198,AN-25,2199,6,6,1991,1990,1997,14,3
2199,AN-25,2200,2,3,1998,1990,2000,14,3
2200,AN-25,2201,2,3,2002,2000,2004,14,3
2201,AN-25,2202,2,3,2012,2010,2014,14,3
2202,AN-25,2203,1,3,2016,2010,2017,14,3
2203,AN-26,2204,6,6,1969,1960,1975,9,3
2204,AN-26,2205,1,3,1976,1970,1977,9,3
2205,AN-26,2206,5,8,1981,1980,1986,9,3
2206,AN-26,2207,3,6,1990,1990,1993,9,3
2207,AN-26,2208,1,5,1995,1990,1996,9,3
2208,AN-26,2209,1,9,1997,1990,1998,9,3
2209,AN-26,2210,5,5,2000,2000,2005,9,3
2210,AN-26,2211,1,3,2006,2000,2007,9,3
2211,AN-26,2212,1,4,2008,2000,2009,9,3
2212,AN-26,2213,1,4,2013,2010,2014,9,3
2213,AN-27,2214,1,4,1963,1960,1964,6,3
2214,AN-27,2215,1,4,1969,1960,1970,6,3
2215,AN-27,2216,1,3,1974,1970,1975,6,3
2216,AN-27,2217,1,4,1979,1970,1980,6,3
2217,AN-27,2218,1,4,1983,1980,1984,6,3
2218,AN-27,2219,1,3,1987,1980,1988,6,3
2219,AN-27,2220,1,3,1992,1990,1993,6,3
2220,AN-27,2221,1,3,1995,1990,1996,6,3
2221,AN-27,2222,1,4,1999,1990,2000,6,3
2222,AN-27,2223,1,3,2002,2000,2003,6,3
2223,AN-27,2224,1,6,2016,2010,2017,6,3
2224,AN-28,2225,1,3,1975,1970,1976,3,3
2225,AN-28,2226,1,3,2010,2010,2011,3,3
2226,AN-29,2227,1,3,1974,1970,1975,4,3
2227,AN-29,2228,1,3,1987,1980,1988,4,3
2228,AN-29,2229,1,4,1993,1990,1994,4,3
2229,AN-29,2230,1,3,2002,2000,2003,4,3
2230,AN-29,2231,1,3,2007,2000,2008,4,3
2231,AN-30,2232,1,4,1996,1990,1997,4,3
2232,AN-30,2233,1,3,2006,2000,2007,4,3
2233,AO-23,2234,1,3,1921,1920,1922,3,3
2234,AO-25,2235,2,4,1967,1960,1969,11,3
2235,AO-25,2236,2,4,1970,1970,1972,11,3
2236,AO-25,2237,5,5,1973,1970,1978,11,3
2237,AO-25,2238,6,11,1979,1970,1985,11,3
2238,AO-25,2239,1,3,1986,1980,1987,11,3
2239,AO-25,2240,1,4,1989,1980,1990,11,3
2240,AO-25,2241,1,6,1992,1990,1993,11,3
2241,AO-25,2242,6,7,1996,1990,2002,11,3
2242,AO-25,2243,10,6,2004,2000,2014,11,3
2243,AO-26,2244,1,3,1946,1940,1947,4,3
2244,AO-26,2245,1,4,1969,1960,1970,4,3
2245,AO-26,2246,1,3,1974,1970,1975,4,3
2246,AO-26,2247,1,4,1981,1980,1982,4,3
2247,AO-26,2248,2,4,1990,1990,1992,4,3
2248,AO-26,2249,3,3,1993,1990,1996,4,3
2249,AO-26,2250,1,3,1998,1990,1999,4,3
2250,AO-26,2251,2,3,2002,2000,2004,4,3
2251,AO-26,2252,1,3,2006,2000,2007,4,3
2252,AO-27,2253,1,3,1970,1970,1971,4,3
2253,AO-27,2254,1,3,1977,1970,1978,4,3
2254,AO-27,2255,1,3,1990,1990,1991,4,3
2255,AO-27,2256,2,3,1992,1990,1994,4,3
2256,AO-27,2257,1,4,1996,1990,1997,4,3
2257,AO-27,2258,1,3,2001,2000,2002,4,3
2258,AO-27,2259,1,3,2003,2000,2004,4,3
2259,AO-27,2260,1,3,2005,2000,2006,4,3
2260,AO-27,2261,1,4,2013,2010,2014,4,3
2261,AO-27,2262,1,3,2015,2010,2016,4,3
2262,AO-28,2263,1,3,1986,1980,1987,3,3
2263,AO-28,2264,1,3,2008,2000,2009,3,3
2264,AO-28,2265,1,3,2010,2010,2011,3,3
2265,AO-29,2266,1,3,2003,2000,2004,5,3
2266,AO-29,2267,1,5,2012,2010,2013,5,3
2267,AP-25,2268,1,3,1968,1960,1969,4,3
2268,AP-25,2269,1,4,1971,1970,1972,4,3
2269,AP-25,2270,1,3,1977,1970,1978,4,3
2270,AP-25,2271,1,4,1979,1970,1980,4,3
2271,AP-25,2272,1,3,1981,1980,1982,4,3
2272,AP-25,2273,1,3,1983,1980,1984,4,3
2273,AP-25,2274,2,3,1992,1990,1994,4,3
2274,AP-25,2275,1,3,2003,2000,2004,4,3
2275,AP-25,2276,1,4,2013,2010,2014,4,3
2276,AP-26,2277,10,9,1970,1970,1980,9,3
2277,AP-26,2278,5,6,1983,1980,1988,9,3
2278,AP-26,2279,1,5,1990,1990,1991,9,3
2279,AP-26,2280,5,8,1994,1990,1999,9,3
2280,AP-26,2281,4,4,2000,2000,2004,9,3
2281,AP-26,2282,1,5,2005,2000,2006,9,3
2282,AP-26,2283,1,3,2009,2000,2010,9,3
2283,AP-26,2284,1,3,2011,2010,2012,9,3
2284,AP-26,2285,1,4,2016,2010,2017,9,3
2285,AP-27,2286,1,3,1976,1970,1977,8,3
2286,AP-27,2287,1,3,1983,1980,1984,8,3
2287,AP-27,2288,1,4,1992,1990,1993,8,3
2288,AP-27,2289,2,8,1994,1990,1996,8,3
2289,AP-27,2290,1,3,1999,1990,2000,8,3
2290,AP-27,2291,1,3,2006,2000,2007,8,3
2291,AP-27,2292,1,3,2015,2010,2016,8,3
2292,AP-28,2293,1,3,1993,1990,1994,5,3
2293,AP-28,2294,1,3,1995,1990,1996,5,3
2294,AP-28,2295,1,5,2006,2000,2007,5,3
2295,AP-29,2296,1,4,1992,1990,1993,4,4
2296,AP-30,2297,1,3,1975,1970,1976,3,3
2297,AP-30,2298,1,3,1988,1980,1989,3,3
2298,AP-30,2299,2,3,1993,1990,1995,3,3
2299,AP-30,2300,1,3,2012,2010,2013,3,3
2300,AP-31,2301,1,8,1966,1960,1967,8,3
2301,AP-31,2302,1,4,1997,1990,1998,8,3
2302,AP-31,2303,1,3,2002,2000,2003,8,3
2303,AQ-25,2304,1,3,1981,1980,1982,3,3
2304,AQ-26,2305,1,3,1954,1950,1955,13,3
2305,AQ-26,2306,28,13,1971,1970,1999,13,3
2306,AQ-26,2307,1,5,2000,2000,2001,13,3
2307,AQ-26,2308,2,5,2003,2000,2005,13,3
2308,AQ-26,2309,1,4,2008,2000,2009,13,3
2309,AQ-26,2310,2,5,2010,2010,2012,13,3
2310,AQ-26,2311,2,5,2013,2010,2015,13,3
2311,AQ-26,2312,1,5,2016,2010,2017,13,3
2312,AQ-27,2313,1,9,1974,1970,1975,13,3
2313,AQ-27,2314,1,4,1976,1970,1977,13,3
2314,AQ-27,2315,1,3,1978,1970,1979,13,3
2315,AQ-27,2316,1,4,1981,1980,1982,13,3
2316,AQ-27,2317,2,5,1983,1980,1985,13,3
2317,AQ-27,2318,3,4,1986,1980,1989,13,3
2318,AQ-27,2319,1,6,1990,1990,1991,13,3
2319,AQ-27,2320,3,13,1992,1990,1995,13,3
2320,AQ-27,2321,1,3,2003,2000,2004,13,3
2321,AQ-27,2322,9,7,2006,2000,2015,13,3
2322,AQ-27,2323,1,5,2016,2010,2017,13,3
2323,AQ-28,2324,1,4,1986,1980,1987,5,4
2324,AQ-28,2325,2,5,1997,1990,1999,5,4
2325,AQ-28,2326,1,4,2001,2000,2002,5,4
2326,AQ-28,2327,1,4,2004,2000,2005,5,4
2327,AQ-28,2328,1,4,2008,2000,2009,5,4
2328,AQ-28,2329,1,4,2012,2010,2013,5,4
2329,AQ-29,2330,1,3,1993,1990,1994,3,3
2330,AQ-31,2331,2,4,1990,1990,1992,4,3
2331,AQ-31,2332,1,3,2000,2000,2001,4,3
2332,AR-27,2333,1,5,1975,1970,1976,7,3
2333,AR-27,2334,2,4,1980,1980,1982,7,3
2334,AR-27,2335,1,3,1984,1980,1985,7,3
2335,AR-27,2336,1,4,1986,1980,1987,7,3
2336,AR-27,2337,1,4,1989,1980,1990,7,3
2337,AR-27,2338,4,7,1991,1990,1995,7,3
2338,AR-27,2339,1,6,1997,1990,1998,7,3
2339,AR-27,2340,1,3,1999,1990,2000,7,3
2340,AR-27,2341,2,3,2001,2000,2003,7,3
2341,AR-27,2342,1,4,2004,2000,2005,7,3
2342,AR-27,2343,2,6,2015,2010,2017,7,3
2343,AR-28,2344,1,4,1976,1970,1977,6,3
2344,AR-28,2345,1,3,1981,1980,1982,6,3
2345,AR-28,2346,3,4,1990,1990,1993,6,3
2346,AR-28,2347,3,6,1994,1990,1997,6,3
2347,AR-28,2348,5,5,2001,2000,2006,6,3
2348,AR-28,2349,1,3,2010,2010,2011,6,3
2349,AR-28,2350,1,3,2012,2010,2013,6,3
2350,AR-28,2351,2,6,2014,2010,2016,6,3
2351,AR-29,2352,1,4,1922,1920,1923,9,3
2352,AR-29,2353,4,4,1972,1970,1976,9,3
2353,AR-29,2354,1,9,1977,1970,1978,9,3
2354,AR-29,2355,1,3,1980,1980,1981,9,3
2355,AR-29,2356,1,5,1984,1980,1985,9,3
2356,AR-29,2357,1,4,1986,1980,1987,9,3
2357,AR-29,2358,7,7,1988,1980,1995,9,3
2358,AR-29,2359,7,7,1996,1990,2003,9,3
2359,AR-29,2360,1,3,2006,2000,2007,9,3
2360,AR-29,2361,2,5,2008,2000,2010,9,3
2361,AR-29,2362,1,4,2012,2010,2013,9,3
2362,AR-29,2363,1,3,2014,2010,2015,9,3
2363,AR-29,2364,1,4,2016,2010,2017,9,3
2364,AS-27,2365,1,3,1996,1990,1997,4,3
2365,AS-27,2366,1,3,2000,2000,2001,4,3
2366,AS-27,2367,2,4,2009,2000,2011,4,3
2367,AS-28,2368,1,3,1930,1930,1931,3,3
2368,AS-28,2369,1,3,1971,1970,1972,3,3
2369,AS-28,2370,1,3,1975,1970,1976,3,3
2370,AS-28,2371,1,3,1986,1980,1987,3,3
2371,AS-29,2372,3,3,1928,1920,1931,4,3
2372,AS-29,2373,1,4,1953,1950,1954,4,3
2373,AS-29,2374,2,3,1960,1960,1962,4,3
2374,AS-29,2375,1,3,1967,1960,1968,4,3
2375,AS-29,2376,1,3,1971,1970,1972,4,3
2376,AS-29,2377,3,3,1978,1970,1981,4,3
2377,AS-29,2378,1,3,1983,1980,1984,4,3
2378,AS-29,2379,1,3,1993,1990,1994,4,3
2379,AS-29,2380,1,3,1995,1990,1996,4,3
2380,AS-37,2381,1,3,1975,1970,1976,3,3
2381,AT-31,2382,1,3,1972,1970,1973,3,3
2382,AT-31,2383,1,3,1982,1980,1983,3,3
2383,AT-32,2384,1,3,2006,2000,2007,3,3
2384,E-5,2385,1,3,1977,1970,1978,3,3
2385,N-3,2386,1,3,1957,1950,1958,3,3
2386,Q-25,2387,1,3,1996,1990,1997,3,3
2387,R-11,2388,1,3,1966,1960,1967,3,3
2388,S-10,2389,1,3,2002,2000,2003,3,3
2389,S-10,2390,1,3,2015,2010,2016,3,3
2390,S-11,2391,1,3,1929,1920,1930,3,3
2391,S-12,2392,1,4,1995,1990,1996,4,4
2392,S-12,2393,1,4,2016,2010,2017,4,4
2393,T-11,2394,2,3,2000,2000,2002,3,3
2394,T-12,2395,1,3,1986,1980,1987,7,3
2395,T-12,2396,2,4,1989,1980,1991,7,3
2396,T-12,2397,2,4,1992,1990,1994,7,3
2397,T-12,2398,1,3,1995,1990,1996,7,3
2398,T-12,2399,1,6,1997,1990,1998,7,3
2399,T-12,2400,1,3,1999,1990,2000,7,3
2400,T-12,2401,4,6,2002,2000,2006,7,3
2401,T-12,2402,1,3,2011,2010,2012,7,3
2402,T-12,2403,1,3,2013,2010,2014,7,3
2403,T-12,2404,2,7,2015,2010,2017,7,3
2404,T-13,2405,1,5,1976,1970,1977,7,3
2405,T-13,2406,1,3,1980,1980,1981,7,3
2406,T-13,2407,3,6,1986,1980,1989,7,3
2407,T-13,2408,1,3,1990,1990,1991,7,3
2408,T-13,2409,4,7,1992,1990,1996,7,3
2409,T-13,2410,2,4,1997,1990,1999,7,3
2410,T-13,2411,4,6,2000,2000,2004,7,3
2411,T-13,2412,1,3,2006,2000,2007,7,3
2412,T-13,2413,1,4,2008,2000,2009,7,3
2413,T-13,2414,6,7,2011,2010,2017,7,3
2414,T-14,2415,1,4,1956,1950,1957,6,3
2415,T-14,2416,1,6,1973,1970,1974,6,3
2416,T-14,2417,6,5,1976,1970,1982,6,3
2417,T-14,2418,3,3,1985,1980,1988,6,3
2418,T-14,2419,3,4,1989,1980,1992,6,3
2419,T-14,2420,1,4,1996,1990,1997,6,3
2420,T-14,2421,1,5,1998,1990,1999,6,3
2421,T-14,2422,1,4,2000,2000,2001,6,3
2422,T-14,2423,1,3,2006,2000,2007,6,3
2423,T-14,2424,3,6,2008,2000,2011,6,3
2424,T-14,2425,2,5,2013,2010,2015,6,3
2425,T-14,2426,1,3,2016,2010,2017,6,3
2426,T-15,2427,12,7,1971,1970,1983,8,3
2427,T-15,2428,2,8,1985,1980,1987,8,3
2428,T-15,2429,7,8,1988,1980,1995,8,3
2429,T-15,2430,3,6,1996,1990,1999,8,3
2430,T-15,2431,4,7,2001,2000,2005,8,3
2431,T-15,2432,1,3,2013,2010,2014,8,3
2432,T-9,2433,1,4,1977,1970,1978,4,4
2433,U-11,2434,1,3,1987,1980,1988,3,3
2434,U-11,2435,1,3,1992,1990,1993,3,3
2435,U-11,2436,1,3,1999,1990,2000,3,3
2436,U-11,2437,1,3,2016,2010,2017,3,3
2437,U-12,2438,1,4,1984,1980,1985,7,3
2438,U-12,2439,1,3,1987,1980,1988,7,3
2439,U-12,2440,1,3,1989,1980,1990,7,3
2440,U-12,2441,3,7,1992,1990,1995,7,3
2441,U-12,2442,1,4,1997,1990,1998,7,3
2442,U-12,2443,2,5,1999,1990,2001,7,3
2443,U-12,2444,3,5,2002,2000,2005,7,3
2444,U-12,2445,1,5,2007,2000,2008,7,3
2445,U-12,2446,1,4,2009,2000,2010,7,3
2446,U-12,2447,1,3,2012,2010,2013,7,3
2447,U-12,2448,2,7,2015,2010,2017,7,3
2448,U-13,2449,1,4,1977,1970,1978,7,3
2449,U-13,2450,2,4,1979,1970,1981,7,3
2450,U-13,2451,1,3,1983,1980,1984,7,3
2451,U-13,2452,1,5,1987,1980,1988,7,3
2452,U-13,2453,7,7,1991,1990,1998,7,3
2453,U-13,2454,4,6,1999,1990,2003,7,3
2454,U-13,2455,2,6,2007,2000,2009,7,3
2455,U-13,2456,1,3,2010,2010,2011,7,3
2456,U-13,2457,2,7,2015,2010,2017,7,3
2457,U-14,2458,2,3,1969,1960,1971,9,3
2458,U-14,2459,12,8,1972,1970,1984,9,3
2459,U-14,2460,4,9,1985,1980,1989,9,3
2460,U-14,2461,13,9,1990,1990,2003,9,3
2461,U-14,2462,6,6,2004,2000,2010,9,3
2462,U-14,2463,2,5,2011,2010,2013,9,3
2463,U-14,2464,1,8,2014,2010,2015,9,3
2464,U-14,2465,1,7,2016,2010,2017,9,3
2465,U-15,2466,1,3,1925,1920,1926,9,3
2466,U-15,2467,2,5,1973,1970,1975,9,3
2467,U-15,2468,2,5,1976,1970,1978,9,3
2468,U-15,2469,3,3,1984,1980,1987,9,3
2469,U-15,2470,2,4,1988,1980,1990,9,3
2470,U-15,2471,1,3,1993,1990,1994,9,3
2471,U-15,2472,1,5,1997,1990,1998,9,3
2472,U-15,2473,1,3,2003,2000,2004,9,3
2473,U-15,2474,1,3,2005,2000,2006,9,3
2474,U-15,2475,1,5,2013,2010,2014,9,3
2475,U-15,2476,2,9,2015,2010,2017,9,3
2476,V-11,2477,1,3,1987,1980,1988,3,3
2477,V-11,2478,1,3,1994,1990,1995,3,3
2478,V-11,2479,1,3,2012,2010,2013,3,3
2479,V-12,2480,1,4,1981,1980,1982,4,3
2480,V-12,2481,2,3,1989,1980,1991,4,3
2481,V-12,2482,2,3,1992,1990,1994,4,3
2482,V-12,2483,2,3,1997,1990,1999,4,3
2483,V-12,2484,1,3,2001,2000,2002,4,3
2484,V-12,2485,1,4,2009,2000,2010,4,3
2485,V-12,2486,1,3,2015,2010,2016,4,3
2486,V-13,2487,1,3,1973,1970,1974,11,3
2487,V-13,2488,1,3,1983,1980,1984,11,3
2488,V-13,2489,1,4,1986,1980,1987,11,3
2489,V-13,2490,9,11,1988,1980,1997,11,3
2490,V-13,2491,2,7,1998,1990,2000,11,3
2491,V-13,2492,4,6,2001,2000,2005,11,3
2492,V-13,2493,2,6,2007,2000,2009,11,3
2493,V-13,2494,1,3,2010,2010,2011,11,3
2494,V-13,2495,1,5,2012,2010,2013,11,3
2495,V-13,2496,2,5,2015,2010,2017,11,3
2496,V-14,2497,1,4,1971,1970,1972,8,3
2497,V-14,2498,4,6,1973,1970,1977,8,3
2498,V-14,2499,2,3,1978,1970,1980,8,3
2499,V-14,2500,2,5,1981,1980,1983,8,3
2500,V-14,2501,1,4,1984,1980,1985,8,3
2501,V-14,2502,3,8,1988,1980,1991,8,3
2502,V-14,2503,1,6,1992,1990,1993,8,3
2503,V-14,2504,9,7,1995,1990,2004,8,3
2504,V-14,2505,5,6,2005,2000,2010,8,3
2505,V-14,2506,2,4,2011,2010,2013,8,3
2506,V-14,2507,3,6,2014,2010,2017,8,3
2507,V-15,2508,13,10,1968,1960,1981,11,3
2508,V-15,2509,1,5,1982,1980,1983,11,3
2509,V-15,2510,3,4,1984,1980,1987,11,3
2510,V-15,2511,5,8,1988,1980,1993,11,3
2511,V-15,2512,7,8,1994,1990,2001,11,3
2512,V-15,2513,2,6,2002,2000,2004,11,3
2513,V-15,2514,2,5,2005,2000,2007,11,3
2514,V-15,2515,2,3,2011,2010,2013,11,3
2515,V-15,2516,3,11,2014,2010,2017,11,3
2516,V-22,2517,1,3,2004,2000,2005,3,3
2517,V-8,2518,1,3,1930,1930,1931,3,3
2518,W-12,2519,1,3,1994,1990,1995,3,3
2519,W-13,2520,1,3,1977,1970,1978,6,3
2520,W-13,2521,2,5,1980,1980,1982,6,3
2521,W-13,2522,1,3,1990,1990,1991,6,3
2522,W-13,2523,1,4,1993,1990,1994,6,3
2523,W-13,2524,1,5,1995,1990,1996,6,3
2524,W-13,2525,1,6,2002,2000,2003,6,3
2525,W-13,2526,1,4,2007,2000,2008,6,3
2526,W-13,2527,1,3,2016,2010,2017,6,3
2527,W-14,2528,1,3,1929,1920,1930,10,3
2528,W-14,2529,8,6,1970,1970,1978,10,3
2529,W-14,2530,3,7,1979,1970,1982,10,3
2530,W-14,2531,5,6,1984,1980,1989,10,3
2531,W-14,2532,2,8,1990,1990,1992,10,3
2532,W-14,2533,3,7,1993,1990,1996,10,3
2533,W-14,2534,1,4,1997,1990,1998,10,3
2534,W-14,2535,3,8,2001,2000,2004,10,3
2535,W-14,2536,2,10,2015,2010,2017,10,3
2536,W-15,2537,2,3,1968,1960,1970,8,3
2537,W-15,2538,3,6,1971,1970,1974,8,3
2538,W-15,2539,2,5,1976,1970,1978,8,3
2539,W-15,2540,1,7,1979,1970,1980,8,3
2540,W-15,2541,2,7,1981,1980,1983,8,3
2541,W-15,2542,2,5,1986,1980,1988,8,3
2542,W-15,2543,2,3,1990,1990,1992,8,3
2543,W-15,2544,1,6,1995,1990,1996,8,3
2544,W-15,2545,3,4,1997,1990,2000,8,3
2545,W-15,2546,2,4,2001,2000,2003,8,3
2546,W-15,2547,1,3,2004,2000,2005,8,3
2547,W-15,2548,1,3,2008,2000,2009,8,3
2548,W-15,2549,3,4,2011,2010,2014,8,3
2549,W-15,2550,2,8,2015,2010,2017,8,3
2550,W-21,2551,1,3,1964,1960,1965,4,3
2551,W-21,2552,1,3,1978,1970,1979,4,3
2552,W-21,2553,1,3,1989,1980,1990,4,3
2553,W-21,2554,1,3,1997,1990,1998,4,3
2554,W-21,2555,1,4,2004,2000,2005,4,3
2555,W-21,2556,1,3,2008,2000,2009,4,3
2556,W-9,2557,1,3,2006,2000,2007,3,3
2557,X-11,2558,1,3,1978,1970,1979,6,3
2558,X-11,2559,1,6,1981,1980,1982,6,3
2559,X-11,2560,1,3,1998,1990,1999,6,3
2560,X-11,2561,1,3,2001,2000,2002,6,3
2561,X-11,2562,1,3,2009,2000,2010,6,3
2562,X-12,2563,1,6,1964,1960,1965,7,3
2563,X-12,2564,2,3,1974,1970,1976,7,3
2564,X-12,2565,1,4,1981,1980,1982,7,3
2565,X-12,2566,1,3,1985,1980,1986,7,3
2566,X-12,2567,2,3,1987,1980,1989,7,3
2567,X-12,2568,1,5,1990,1990,1991,7,3
2568,X-12,2569,5,7,1992,1990,1997,7,3
2569,X-12,2570,2,5,2001,2000,2003,7,3
2570,X-12,2571,1,3,2004,2000,2005,7,3
2571,X-12,2572,1,3,2006,2000,2007,7,3
2572,X-12,2573,1,3,2008,2000,2009,7,3
2573,X-12,2574,1,3,2011,2010,2012,7,3
2574,X-13,2575,1,4,1985,1980,1986,7,3
2575,X-13,2576,1,3,1987,1980,1988,7,3
2576,X-13,2577,3,4,1992,1990,1995,7,3
2577,X-13,2578,2,7,1996,1990,1998,7,3
2578,X-13,2579,1,3,1999,1990,2000,7,3
2579,X-13,2580,3,4,2001,2000,2004,7,3
2580,X-13,2581,4,6,2006,2000,2010,7,3
2581,X-13,2582,2,3,2014,2010,2016,7,3
2582,X-14,2583,1,3,1971,1970,1972,6,3
2583,X-14,2584,1,3,1977,1970,1978,6,3
2584,X-14,2585,1,6,1980,1980,1981,6,3
2585,X-14,2586,1,3,1989,1980,1990,6,3
2586,X-14,2587,1,3,1995,1990,1996,6,3
2587,X-14,2588,1,3,1999,1990,2000,6,3
2588,X-14,2589,1,3,2001,2000,2002,6,3
2589,X-14,2590,1,3,2010,2010,2011,6,3
2590,X-15,2591,1,3,1958,1950,1959,20,3
2591,X-15,2592,1,3,1963,1960,1964,20,3
2592,X-15,2593,12,10,1965,1960,1977,20,3
2593,X-15,2594,39,20,1978,1970,2017,20,3
2594,X-16,2595,1,5,1959,1950,1960,6,3
2595,X-16,2596,3,6,1964,1960,1967,6,3
2596,X-16,2597,1,4,1968,1960,1969,6,3
2597,X-16,2598,2,5,1970,1970,1972,6,3
2598,X-16,2599,2,5,1973,1970,1975,6,3
2599,X-16,2600,7,4,1977,1970,1984,6,3
2600,X-16,2601,1,4,1987,1980,1988,6,3
2601,X-16,2602,1,3,1989,1980,1990,6,3
2602,X-16,2603,1,5,1992,1990,1993,6,3
2603,X-16,2604,3,5,1994,1990,1997,6,3
2604,X-16,2605,2,5,1998,1990,2000,6,3
2605,X-16,2606,1,4,2001,2000,2002,6,3
2606,X-16,2607,1,3,2012,2010,2013,6,3
2607,X-16,2608,1,6,2015,2010,2016,6,3
2608,X-17,2609,1,4,1962,1960,1963,5,3
2609,X-17,2610,1,3,1966,1960,1967,5,3
2610,X-17,2611,2,4,1968,1960,1970,5,3
2611,X-17,2612,2,5,1975,1970,1977,5,3
2612,X-17,2613,2,4,1978,1970,1980,5,3
2613,X-17,2614,1,4,1981,1980,1982,5,3
2614,X-17,2615,1,3,1983,1980,1984,5,3
2615,X-17,2616,1,4,1986,1980,1987,5,3
2616,X-17,2617,3,4,1989,1980,1992,5,3
2617,X-17,2618,1,3,1996,1990,1997,5,3
2618,X-17,2619,1,4,2001,2000,2002,5,3
2619,X-17,2620,1,4,2005,2000,2006,5,3
2620,X-18,2621,1,3,1969,1960,1970,7,3
2621,X-18,2622,1,3,1973,1970,1974,7,3
2622,X-18,2623,1,4,1981,1980,1982,7,3
2623,X-18,2624,1,5,1990,1990,1991,7,3
2624,X-18,2625,1,3,1992,1990,1993,7,3
2625,X-18,2626,1,5,1994,1990,1995,7,3
2626,X-18,2627,2,5,1998,1990,2000,7,3
2627,X-18,2628,2,7,2002,2000,2004,7,3
2628,X-18,2629,2,5,2008,2000,2010,7,3
2629,X-18,2630,1,6,2012,2010,2013,7,3
2630,X-18,2631,1,3,2014,2010,2015,7,3
2631,X-18,2632,1,3,2016,2010,2017,7,3
2632,X-19,2633,1,3,1977,1970,1978,4,3
2633,X-19,2634,1,3,1984,1980,1985,4,3
2634,X-19,2635,2,3,2001,2000,2003,4,3
2635,X-19,2636,1,4,2008,2000,2009,4,3
2636,X-19,2637,1,3,2011,2010,2012,4,3
2637,X-19,2638,2,4,2013,2010,2015,4,3
2638,X-23,2639,1,4,1929,1920,1930,4,4
2639,X-24,2640,1,4,2010,2010,2011,4,4
2640,X-7,2641,1,3,1929,1920,1930,3,3
2641,X-7,2642,1,3,1987,1980,1988,3,3
2642,Y-10,2643,1,4,1989,1980,1990,4,3
2643,Y-10,2644,1,4,1993,1990,1994,4,3
2644,Y-10,2645,1,3,2000,2000,2001,4,3
2645,Y-10,2646,3,4,2002,2000,2005,4,3
2646,Y-10,2647,1,3,2008,2000,2009,4,3
2647,Y-10,2648,1,3,2014,2010,2015,4,3
2648,Y-11,2649,1,4,1977,1970,1978,7,3
2649,Y-11,2650,1,3,1980,1980,1981,7,3
2650,Y-11,2651,1,4,1984,1980,1985,7,3
2651,Y-11,2652,6,7,1990,1990,1996,7,3
2652,Y-11,2653,1,4,2005,2000,2006,7,3
2653,Y-11,2654,1,3,2008,2000,2009,7,3
2654,Y-12,2655,1,3,1921,1920,1922,13,3
2655,Y-12,2656,3,3,1979,1970,1982,13,3
2656,Y-12,2657,4,6,1983,1980,1987,13,3
2657,Y-12,2658,16,12,1988,1980,2004,13,3
2658,Y-12,2659,5,6,2006,2000,2011,13,3
2659,Y-12,2660,5,13,2012,2010,2017,13,3
2660,Y-13,2661,2,5,1971,1970,1973,12,4
2661,Y-13,2662,1,5,1976,1970,1977,12,4
2662,Y-13,2663,4,9,1978,1970,1982,12,4
2663,Y-13,2664,1,6,1983,1980,1984,12,4
2664,Y-13,2665,2,4,1985,1980,1987,12,4
2665,Y-13,2666,15,12,1988,1980,2003,12,4
2666,Y-13,2667,1,6,2004,2000,2005,12,4
2667,Y-13,2668,6,8,2007,2000,2013,12,4
2668,Y-13,2669,3,6,2014,2010,2017,12,4
2669,Y-14,2670,1,3,1928,1920,1929,14,3
2670,Y-14,2671,1,3,1944,1940,1945,14,3
2671,Y-14,2672,21,11,1966,1960,1987,14,3
2672,Y-14,2673,13,14,1988,1980,2001,14,3
2673,Y-14,2674,1,3,2003,2000,2004,14,3
2674,Y-14,2675,2,3,2005,2000,2007,14,3
2675,Y-14,2676,1,5,2008,2000,2009,14,3
2676,Y-14,2677,3,4,2014,2010,2017,14,3
2677,Y-15,2678,1,3,1930,1930,1931,16,3
2678,Y-15,2679,2,3,1946,1940,1948,16,3
2679,Y-15,2680,1,5,1961,1960,1962,16,3
2680,Y-15,2681,20,16,1963,1960,1983,16,3
2681,Y-15,2682,6,8,1984,1980,1990,16,3
2682,Y-15,2683,22,9,1991,1990,2013,16,3
2683,Y-15,2684,3,8,2014,2010,2017,16,3
2684,Y-16,2685,1,3,1922,1920,1923,14,3
2685,Y-16,2686,3,6,1957,1950,1960,14,3
2686,Y-16,2687,28,11,1961,1960,1989,14,3
2687,Y-16,2688,7,14,1990,1990,1997,14,3
2688,Y-16,2689,4,6,1999,1990,2003,14,3
2689,Y-16,2690,3,5,2004,2000,2007,14,3
2690,Y-16,2691,4,5,2008,2000,2012,14,3
2691,Y-16,2692,2,8,2015,2010,2017,14,3
2692,Y-17,2693,1,4,1924,1920,1925,11,3
2693,Y-17,2694,1,3,1956,1950,1957,11,3
2694,Y-17,2695,1,3,1959,1950,1960,11,3
2695,Y-17,2696,9,11,1966,1960,1975,11,3
2696,Y-17,2697,1,5,1976,1970,1977,11,3
2697,Y-17,2698,5,5,1979,1970,1984,11,3
2698,Y-17,2699,5,7,1986,1980,1991,11,3
2699,Y-17,2700,5,6,1992,1990,1997,11,3
2700,Y-17,2701,2,5,1998,1990,2000,11,3
2701,Y-17,2702,2,3,2003,2000,2005,11,3
2702,Y-17,2703,1,6,2006,2000,2007,11,3
2703,Y-17,2704,1,3,2010,2010,2011,11,3
2704,Y-18,2705,2,6,1980,1980,1982,7,3
2705,Y-18,2706,1,3,1983,1980,1984,7,3
2706,Y-18,2707,2,5,1986,1980,1988,7,3
2707,Y-18,2708,1,7,1989,1980,1990,7,3
2708,Y-18,2709,4,7,1994,1990,1998,7,3
2709,Y-18,2710,3,5,1999,1990,2002,7,3
2710,Y-18,2711,2,5,2003,2000,2005,7,3
2711,Y-18,2712,1,3,2007,2000,2008,7,3
2712,Y-18,2713,2,4,2015,2010,2017,7,3
2713,Y-22,2714,1,3,1993,1990,1994,3,3
2714,Y-23,2715,1,3,1990,1990,1991,3,3
2715,Y-25,2716,1,3,2016,2010,2017,3,3
2716,Y-6,2717,1,3,1975,1970,1976,4,3
2717,Y-6,2718,1,4,1983,1980,1984,4,3
2718,Y-9,2719,1,4,1976,1970,1977,4,3
2719,Y-9,2720,1,3,1983,1980,1984,4,3
2720,Y-9,2721,1,3,1986,1980,1987,4,3
2721,Y-9,2722,1,4,1998,1990,1999,4,3
2722,Y-9,2723,2,4,2001,2000,2003,4,3
2723,Y-9,2724,1,4,2004,2000,2005,4,3
2724,Y-9,2725,1,3,2006,2000,2007,4,3
2725,Z-10,2726,1,3,1985,1980,1986,4,3
2726,Z-10,2727,1,4,1987,1980,1988,4,3
2727,Z-10,2728,2,3,1992,1990,1994,4,3
2728,Z-10,2729,2,4,1995,1990,1997,4,3
2729,Z-10,2730,1,4,2001,2000,2002,4,3
2730,Z-11,2731,2,6,1975,1970,1977,8,3
2731,Z-11,2732,4,6,1978,1970,1982,8,3
2732,Z-11,2733,1,5,1984,1980,1985,8,3
2733,Z-11,2734,2,4,1986,1980,1988,8,3
2734,Z-11,2735,3,7,1989,1980,1992,8,3
2735,Z-11,2736,3,3,1993,1990,1996,8,3
2736,Z-11,2737,1,3,1999,1990,2000,8,3
2737,Z-11,2738,2,8,2002,2000,2004,8,3
2738,Z-12,2739,1,4,1971,1970,1972,8,3
2739,Z-12,2740,2,3,1974,1970,1976,8,3
2740,Z-12,2741,9,8,1977,1970,1986,8,3
2741,Z-12,2742,4,5,1989,1980,1993,8,3
2742,Z-12,2743,1,4,1994,1990,1995,8,3
2743,Z-12,2744,4,3,1996,1990,2000,8,3
2744,Z-12,2745,1,4,2001,2000,2002,8,3
2745,Z-12,2746,1,3,2006,2000,2007,8,3
2746,Z-12,2747,1,4,2016,2010,2017,8,3
2747,Z-13,2748,1,3,1920,1920,1921,8,3
2748,Z-13,2749,1,3,1973,1970,1974,8,3
2749,Z-13,2750,1,5,1978,1970,1979,8,3
2750,Z-13,2751,1,6,1981,1980,1982,8,3
2751,Z-13,2752,2,4,1985,1980,1987,8,3
2752,Z-13,2753,1,3,1989,1980,1990,8,3
2753,Z-13,2754,13,8,1991,1990,2004,8,3
2754,Z-13,2755,1,4,2006,2000,2007,8,3
2755,Z-13,2756,2,6,2008,2000,2010,8,3
2756,Z-13,2757,1,5,2011,2010,2012,8,3
2757,Z-13,2758,1,4,2014,2010,2015,8,3
2758,Z-13,2759,1,4,2016,2010,2017,8,3
2759,Z-14,2760,1,3,1961,1960,1962,11,3
2760,Z-14,2761,1,3,1965,1960,1966,11,3
2761,Z-14,2762,1,3,1967,1960,1968,11,3
2762,Z-14,2763,1,6,1970,1970,1971,11,3
2763,Z-14,2764,1,3,1973,1970,1974,11,3
2764,Z-14,2765,1,4,1977,1970,1978,11,3
2765,Z-14,2766,5,7,1981,1980,1986,11,3
2766,Z-14,2767,15,11,1989,1980,2004,11,3
2767,Z-14,2768,1,4,2005,2000,2006,11,3
2768,Z-14,2769,3,5,2010,2010,2013,11,3
2769,Z-14,2770,1,4,2014,2010,2015,11,3
2770,Z-15,2771,19,11,1962,1960,1981,11,3
2771,Z-15,2772,2,5,1985,1980,1987,11,3
2772,Z-15,2773,3,4,1988,1980,1991,11,3
2773,Z-15,2774,1,4,1995,1990,1996,11,3
2774,Z-15,2775,1,4,1999,1990,2000,11,3
2775,Z-15,2776,2,6,2003,2000,2005,11,3
2776,Z-15,2777,1,3,2006,2000,2007,11,3
2777,Z-15,2778,1,5,2009,2000,2010,11,3
2778,Z-15,2779,1,5,2016,2010,2017,11,3
2779,Z-16,2780,2,4,1923,1920,1925,14,3
2780,Z-16,2781,1,4,1926,1920,1927,14,3
2781,Z-16,2782,1,4,1954,1950,1955,14,3
2782,Z-16,2783,5,9,1956,1950,1961,14,3
2783,Z-16,2784,20,11,1962,1960,1982,14,3
2784,Z-16,2785,1,4,1984,1980,1985,14,3
2785,Z-16,2786,2,3,1987,1980,1989,14,3
2786,Z-16,2787,3,6,1990,1990,1993,14,3
2787,Z-16,2788,1,5,1996,1990,1997,14,3
2788,Z-16,2789,1,3,1999,1990,2000,14,3
2789,Z-16,2790,1,5,2001,2000,2002,14,3
2790,Z-16,2791,3,4,2003,2000,2006,14,3
2791,Z-16,2792,2,4,2008,2000,2010,14,3
2792,Z-16,2793,2,14,2015,2010,2017,14,3
2793,Z-17,2794,1,3,1951,1950,1952,23,3
2794,Z-17,2795,1,3,1953,1950,1954,23,3
2795,Z-17,2796,1,5,1955,1950,1956,23,3
2796,Z-17,2797,39,23,1958,1950,1997,23,3
2797,Z-17,2798,6,5,1998,1990,2004,23,3
2798,Z-17,2799,6,10,2005,2000,2011,23,3
2799,Z-17,2800,5,6,2012,2010,2017,23,3
2800,Z-18,2801,1,3,1960,1960,1961,9,3
2801,Z-18,2802,2,5,1966,1960,1968,9,3
2802,Z-18,2803,1,3,1977,1970,1978,9,3
2803,Z-18,2804,3,9,1979,1970,1982,9,3
2804,Z-18,2805,14,8,1983,1980,1997,9,3
2805,Z-18,2806,2,5,1998,1990,2000,9,3
2806,Z-18,2807,1,8,2001,2000,2002,9,3
2807,Z-18,2808,2,6,2003,2000,2005,9,3
2808,Z-18,2809,3,6,2006,2000,2009,9,3
2809,Z-18,2810,1,3,2010,2010,2011,9,3
2810,Z-19,2811,1,4,1981,1980,1982,4,3
2811,Z-19,2812,1,3,1984,1980,1985,4,3
2812,Z-19,2813,1,3,1989,1980,1990,4,3
2813,Z-19,2814,1,3,1994,1990,1995,4,3
2814,Z-19,2815,1,4,1996,1990,1997,4,3
2815,Z-23,2816,1,3,1998,1990,1999,3,3
2816,Z-6,2817,1,4,1988,1980,1989,4,3
2817,Z-6,2818,1,3,2003,2000,2004,4,3
2818,Z-7,2819,1,5,1993,1990,1994,5,5
2819,Z-7,2820,2,5,1995,1990,1997,5,5
2820,Z-8,2821,1,4,2000,2000,2001,4,3
2821,Z-8,2822,1,3,2011,2010,2012,4,3
2822,Z-9,2823,1,3,1995,1990,1996,3,3
2823,Z-9,2824,1,3,1999,1990,2000,3,3
